がんばりや	Hardy	固有名詞	
さみしがり	Lonely	固有名詞	
ゆうかん	Brave	固有名詞	
いじっぱり	Adamant	固有名詞	
やんちゃ	Naughty	固有名詞	
ずぶとい	Bold	固有名詞	
すなお	Docile	固有名詞	
のんき	Relaxed	固有名詞	
わんぱく	Impish	固有名詞	
のうてんき	Lax	固有名詞	
おくびょう	Timid	固有名詞	
せっかち	Hasty	固有名詞	
まじめ	Serious	固有名詞	
ようき	Jolly	固有名詞	
むじゃき	Naive	固有名詞	
ひかえめ	Modest	固有名詞	
おっとり	Mild	固有名詞	
れいせい	Quiet	固有名詞	
てれや	Bashful	固有名詞	
うっかりや	Rash	固有名詞	
おだやか	Calm	固有名詞	
おとなしい	Gentle	固有名詞	
なまいき	Sassy	固有名詞	
しんちょう	Careful	固有名詞	
きまぐれ	Quirky	固有名詞	
