がんばりや	がんばりや	固有名詞	
さみしがり	さみしがり	固有名詞	
ゆうかん	ゆうかん	固有名詞	
いじっぱり	いじっぱり	固有名詞	
やんちゃ	やんちゃ	固有名詞	
ずぶとい	ずぶとい	固有名詞	
すなお	すなお	固有名詞	
のんき	のんき	固有名詞	
わんぱく	わんぱく	固有名詞	
のうてんき	のうてんき	固有名詞	
おくびょう	おくびょう	固有名詞	
せっかち	せっかち	固有名詞	
まじめ	まじめ	固有名詞	
ようき	ようき	固有名詞	
むじゃき	むじゃき	固有名詞	
ひかえめ	ひかえめ	固有名詞	
おっとり	おっとり	固有名詞	
れいせい	れいせい	固有名詞	
てれや	てれや	固有名詞	
うっかりや	うっかりや	固有名詞	
おだやか	おだやか	固有名詞	
おとなしい	おとなしい	固有名詞	
なまいき	なまいき	固有名詞	
しんちょう	しんちょう	固有名詞	
きまぐれ	きまぐれ	固有名詞	
