きのみ	きのみ	固有名詞
おうごんのみ	おうごんのみ	固有名詞
どくけしのみ	どくけしのみ	固有名詞
まひなおしのみ	まひなおしのみ	固有名詞
はっかのみ	はっかのみ	固有名詞
やけたきのみ	やけたきのみ	固有名詞
こおったきのみ	こおったきのみ	固有名詞
にがいきのみ	にがいきのみ	固有名詞
ふしぎなきのみ	ふしぎなきのみ	固有名詞
きせきのみ	きせきのみ	固有名詞
くらぼのみ	クラボのみ	固有名詞
かごのみ	カゴのみ	固有名詞
ももんのみ	モモンのみ	固有名詞
ちーごのみ	チーゴのみ	固有名詞
ななしのみ	ナナシのみ	固有名詞
ひめりのみ	ヒメリのみ	固有名詞
おれんのみ	オレンのみ	固有名詞
きーのみ	キーのみ	固有名詞
らむのみ	ラムのみ	固有名詞
おぼんのみ	オボンのみ	固有名詞
ふぃらのみ	フィラのみ	固有名詞
ういのみ	ウイのみ	固有名詞
まごのみ	マゴのみ	固有名詞
ばんじのみ	バンジのみ	固有名詞
いあのみ	イアのみ	固有名詞
ずりのみ	ズリのみ	固有名詞
ぶりーのみ	ブリーのみ	固有名詞
ななのみ	ナナのみ	固有名詞
せしなのみ	セシナのみ	固有名詞
ぱいるのみ	パイルのみ	固有名詞
ざろくのみ	ザロクのみ	固有名詞
ねこぶのみ	ネコブのみ	固有名詞
たぽるのみ	タポルのみ	固有名詞
ろめのみ	ロメのみ	固有名詞
うぶのみ	ウブのみ	固有名詞
まとまのみ	マトマのみ	固有名詞
もこしのみ	モコシのみ	固有名詞
ごすのみ	ゴスのみ	固有名詞
らぶたのみ	ラブタのみ	固有名詞
のめるのみ	ノメルのみ	固有名詞
のわきのみ	ノワキのみ	固有名詞
しーやのみ	シーヤのみ	固有名詞
かいすのみ	カイスのみ	固有名詞
どりのみ	ドリのみ	固有名詞
べりぶのみ	ベリブのみ	固有名詞
ちいらのみ	チイラのみ	固有名詞
りゅがのみ	リュガのみ	固有名詞
かむらのみ	カムラのみ	固有名詞
やたぴのみ	ヤタピのみ	固有名詞
ずあのみ	ズアのみ	固有名詞
さんのみ	サンのみ	固有名詞
すたーのみ	スターのみ	固有名詞
なぞのみ	ナゾのみ	固有名詞
おっかのみ	オッカのみ	固有名詞
いとけのみ	イトケのみ	固有名詞
そくののみ	ソクノのみ	固有名詞
りんどのみ	リンドのみ	固有名詞
やちぇのみ	ヤチェのみ	固有名詞
よぷのみ	ヨプのみ	固有名詞
びあーのみ	ビアーのみ	固有名詞
しゅかのみ	シュカのみ	固有名詞
ばこうのみ	バコウのみ	固有名詞
うたんのみ	ウタンのみ	固有名詞
たんがのみ	タンガのみ	固有名詞
よろぎのみ	ヨロギのみ	固有名詞
かしぶのみ	カシブのみ	固有名詞
はばんのみ	ハバンのみ	固有名詞
なものみ	ナモのみ	固有名詞
りりばのみ	リリバのみ	固有名詞
ほずのみ	ホズのみ	固有名詞
みくるのみ	ミクルのみ	固有名詞
いばんのみ	イバンのみ	固有名詞
じゃぽのみ	ジャポのみ	固有名詞
れんぶのみ	レンブのみ	固有名詞
ろぜるのみ	ロゼルのみ	固有名詞
あっきのみ	アッキのみ	固有名詞
たらぷのみ	タラプのみ	固有名詞
ぽふのみ	ポフのみ	固有名詞
