きのみ	Berry	固有名詞
おうごんのみ	Gold Berry	固有名詞
どくけしのみ	PSNCureBerry	固有名詞
まひなおしのみ	PRZCureBerry	固有名詞
はっかのみ	Mint Berry	固有名詞
やけたきのみ	Burnt Berry	固有名詞
こおったきのみ	Ice Berry	固有名詞
にがいきのみ	Bitter Berry	固有名詞
ふしぎなきのみ	MysteryBerry	固有名詞
きせきのみ	MiracleBerry	固有名詞
くらぼのみ	Cheri Berry	固有名詞
かごのみ	Chesto Berry	固有名詞
ももんのみ	Pecha Berry	固有名詞
ちーごのみ	Rawst Berry	固有名詞
ななしのみ	Aspear Berry	固有名詞
ひめりのみ	Leppa Berry	固有名詞
おれんのみ	Oran Berry	固有名詞
きーのみ	Persim Berry	固有名詞
らむのみ	Lum Berry	固有名詞
おぼんのみ	Sitrus Berry	固有名詞
ふぃらのみ	Figy Berry	固有名詞
ういのみ	Wiki Berry	固有名詞
まごのみ	Mago Berry	固有名詞
ばんじのみ	Aguav Berry	固有名詞
いあのみ	Iapapa Berry	固有名詞
ずりのみ	Razz Berry	固有名詞
ぶりーのみ	Bluk Berry	固有名詞
ななのみ	Nanab Berry	固有名詞
せしなのみ	Wepear Berry	固有名詞
ぱいるのみ	Pinap Berry	固有名詞
ざろくのみ	Pomeg Berry	固有名詞
ねこぶのみ	Kelpsy Berry	固有名詞
たぽるのみ	Qualot Berry	固有名詞
ろめのみ	Hondew Berry	固有名詞
うぶのみ	Grepa Berry	固有名詞
まとまのみ	Tamato Berry	固有名詞
もこしのみ	Cornn Berry	固有名詞
ごすのみ	Magost Berry	固有名詞
らぶたのみ	Rabuta Berry	固有名詞
のめるのみ	Nomel Berry	固有名詞
のわきのみ	Spelon Berry	固有名詞
しーやのみ	Pamtre Berry	固有名詞
かいすのみ	Watmel Berry	固有名詞
どりのみ	Durin Berry	固有名詞
べりぶのみ	Belue Berry	固有名詞
ちいらのみ	Liechi Berry	固有名詞
りゅがのみ	Ganlon Berry	固有名詞
かむらのみ	Salac Berry	固有名詞
やたぴのみ	Petaya Berry	固有名詞
ずあのみ	Apicot Berry	固有名詞
さんのみ	Lansat Berry	固有名詞
すたーのみ	Starf Berry	固有名詞
なぞのみ	Enigma Berry	固有名詞
おっかのみ	Occa Berry	固有名詞
いとけのみ	Passho Berry	固有名詞
そくののみ	Wacan Berry	固有名詞
りんどのみ	Rindo Berry	固有名詞
やちぇのみ	Yache Berry	固有名詞
よぷのみ	Chople Berry	固有名詞
びあーのみ	Kebia Berry	固有名詞
しゅかのみ	Shuca Berry	固有名詞
ばこうのみ	Coba Berry	固有名詞
うたんのみ	Payapa Berry	固有名詞
たんがのみ	Tanga Berry	固有名詞
よろぎのみ	Charti Berry	固有名詞
かしぶのみ	Kasib Berry	固有名詞
はばんのみ	Haban Berry	固有名詞
なものみ	Colbur Berry	固有名詞
りりばのみ	Babiri Berry	固有名詞
ほずのみ	Chilan Berry	固有名詞
みくるのみ	Micle Berry	固有名詞
いばんのみ	Custap Berry	固有名詞
じゃぽのみ	Jaboca Berry	固有名詞
れんぶのみ	Rowap Berry	固有名詞
ろぜるのみ	Roseli Berry	固有名詞
あっきのみ	Kee Berry	固有名詞
たらぷのみ	Maranga Berry	固有名詞
ぽふのみ	Hopo Berry	固有名詞
