ふしぎだね	Fushigidane	固有名詞	
ふしぎそう	Fushigisou	固有名詞	
ふしぎばな	Fushigibana	固有名詞	
ひとかげ	Hitokage	固有名詞	
りざーど	Lizardo	固有名詞	
りざーどん	Lizardon	固有名詞	
ぜにがめ	Zenigame	固有名詞	
かめーる	Kameil	固有名詞	
かめっくす	Kamex	固有名詞	
きゃたぴー	Caterpie	固有名詞	
とらんせる	Transel	固有名詞	
ばたふりー	Butterfree	固有名詞	
びーどる	Beedle	固有名詞	
こくーん	Cocoon	固有名詞	
すぴあー	Spear	固有名詞	
ぽっぽ	Poppo	固有名詞	
ぴじょん	Pigeon	固有名詞	
ぴじょっと	Pigeot	固有名詞	
こらった	Koratta	固有名詞	
らった	Ratta	固有名詞	
おにすずめ	Onisuzume	固有名詞	
おにどりる	Onidrill	固有名詞	
あーぼ	Arbo	固有名詞	
あーぼっく	Arbok	固有名詞	
ぴかちゅう	Pikachu	固有名詞	
らいちゅう	Raichu	固有名詞	
さんど	Sand	固有名詞	
さんどぱん	Sandpan	固有名詞	
にどらん♀	Nidoran♀	固有名詞	
にどりーな	Nidorina	固有名詞	
にどくいん	Nidoqueen	固有名詞	
にどらん♂	Nidoran♂	固有名詞	
にどりーの	Nidorino	固有名詞	
にどきんぐ	Nidoking	固有名詞	
ぴっぴ	Pippi	固有名詞	
ぴくしー	Pixy	固有名詞	
ろこん	Rokon	固有名詞	
きゅうこん	Kyukon	固有名詞	
ぷりん	Purin	固有名詞	
ぷくりん	Pukurin	固有名詞	
ずばっと	Zubat	固有名詞	
ごるばっと	Golbat	固有名詞	
なぞのくさ	Nazonokusa	固有名詞	
くさいはな	Kusaihana	固有名詞	
らふれしあ	Ruffresia	固有名詞	
ぱらす	Paras	固有名詞	
ぱらせくと	Parasect	固有名詞	
こんぱん	Kongpang	固有名詞	
もるふぉん	Morphon	固有名詞	
でぃぐだ	Digda	固有名詞	
だぐとりお	Dugtrio	固有名詞	
にゃーす	Nyarth	固有名詞	
ぺるしあん	Persian	固有名詞	
こだっく	Koduck	固有名詞	
ごるだっく	Golduck	固有名詞	
まんきー	Mankey	固有名詞	
おこりざる	Okorizaru	固有名詞	
がーでぃ	Gardie	固有名詞	
ういんでぃ	Windie	固有名詞	
にょろも	Nyoromo	固有名詞	
にょろぞ	Nyorozo	固有名詞	
にょろぼん	Nyorobon	固有名詞	
けーしぃ	Casey	固有名詞	
ゆんげらー	Yungerer	固有名詞	
ふーでぃん	Foodin	固有名詞	
わんりきー	Wanriky	固有名詞	
ごーりきー	Goriky	固有名詞	
かいりきー	Kairiky	固有名詞	
まだつぼみ	Madatsubomi	固有名詞	
うつどん	Utsudon	固有名詞	
うつぼっと	Utsubot	固有名詞	
めのくらげ	Menokurage	固有名詞	
どくくらげ	Dokukurage	固有名詞	
いしつぶて	Isitsubute	固有名詞	
ごろーん	Golone	固有名詞	
ごろーにゃ	Golonya	固有名詞	
ぽにーた	Ponyta	固有名詞	
ぎゃろっぷ	Gallop	固有名詞	
やどん	Yadon	固有名詞	
やどらん	Yadoran	固有名詞	
こいる	Coil	固有名詞	
れあこいる	Rarecoil	固有名詞	
かもねぎ	Kamonegi	固有名詞	
どーどー	Dodo	固有名詞	
どーどりお	Dodorio	固有名詞	
ぱうわう	Pawou	固有名詞	
じゅごん	Jugon	固有名詞	
べとべたー	Betbeter	固有名詞	
べとべとん	Betbeton	固有名詞	
しぇるだー	Shellder	固有名詞	
ぱるしぇん	Parshen	固有名詞	
ごーす	Ghos	固有名詞	
ごーすと	Ghost	固有名詞	
げんがー	Gangar	固有名詞	
いわーく	Iwark	固有名詞	
すりーぷ	Sleepe	固有名詞	
すりーぱー	Sleeper	固有名詞	
くらぶ	Crab	固有名詞	
きんぐらー	Kingler	固有名詞	
びりりだま	Biriridama	固有名詞	
まるまいん	Marumine	固有名詞	
たまたま	Tamatama	固有名詞	
なっしー	Nassy	固有名詞	
からから	Karakara	固有名詞	
がらがら	Garagara	固有名詞	
さわむらー	Sawamular	固有名詞	
えびわらー	Ebiwalar	固有名詞	
べろりんが	Beroringa	固有名詞	
どがーす	Dogars	固有名詞	
またどがす	Matadogas	固有名詞	
さいほーん	Sihorn	固有名詞	
さいどん	Sidon	固有名詞	
らっきー	Lucky	固有名詞	
もんじゃら	Monjara	固有名詞	
がるーら	Garura	固有名詞	
たっつー	Tattu	固有名詞	
しーどら	Seadra	固有名詞	
とさきんと	Tosakinto	固有名詞	
あずまおう	Azumao	固有名詞	
ひとでまん	Hitodeman	固有名詞	
すたーみー	Starmie	固有名詞	
ばりやーど	Barrierd	固有名詞	
すとらいく	Strike	固有名詞	
るーじゅら	Rougela	固有名詞	
えれぶー	Eleboo	固有名詞	
ぶーばー	Boober	固有名詞	
かいろす	Kailios	固有名詞	
けんたろす	Kentauros	固有名詞	
こいきんぐ	Koiking	固有名詞	
ぎゃらどす	Gyarados	固有名詞	
らぷらす	Laplace	固有名詞	
めたもん	Metamon	固有名詞	
いーぶい	Eievui	固有名詞	
しゃわーず	Showers	固有名詞	
さんだーす	Thunders	固有名詞	
ぶーすたー	Booster	固有名詞	
ぽりごん	Porygon	固有名詞	
おむないと	Omnite	固有名詞	
おむすたー	Omstar	固有名詞	
かぶと	Kabuto	固有名詞	
かぶとぷす	Kabutops	固有名詞	
ぷてら	Ptera	固有名詞	
かびごん	Kabigon	固有名詞	
ふりーざー	Freezer	固有名詞	
さんだー	Thunder	固有名詞	
ふぁいやー	Fire	固有名詞	
みにりゅう	Miniryu	固有名詞	
はくりゅー	Hakuryu	固有名詞	
かいりゅー	Kairyu	固有名詞	
みゅうつー	Mewtwo	固有名詞	
みゅう	Mew	固有名詞	
ちこりーた	Chicorita	固有名詞	
べいりーふ	Bayleaf	固有名詞	
めがにうむ	Meganium	固有名詞	
ひのあらし	Hinoarashi	固有名詞	
まぐまらし	Magmarashi	固有名詞	
ばくふーん	Bakphoon	固有名詞	
わにのこ	Waninoko	固有名詞	
ありげいつ	Alligates	固有名詞	
おーだいる	Ordile	固有名詞	
おたち	Otachi	固有名詞	
おおたち	Ootachi	固有名詞	
ほーほー	Hoho	固有名詞	
よるのずく	Yorunozuku	固有名詞	
れでぃば	Rediba	固有名詞	
れでぃあん	Redian	固有名詞	
いとまる	Itomaru	固有名詞	
ありあどす	Ariados	固有名詞	
くろばっと	Crobat	固有名詞	
ちょんちー	Chonchie	固有名詞	
らんたーん	Lantern	固有名詞	
ぴちゅー	Pichu	固有名詞	
ぴぃ	Py	固有名詞	
ぷぷりん	Pupurin	固有名詞	
とげぴー	Togepy	固有名詞	
とげちっく	Togechick	固有名詞	
ねいてぃ	Naty	固有名詞	
ねいてぃお	Natio	固有名詞	
めりーぷ	Merriep	固有名詞	
もここ	Mokoko	固有名詞	
でんりゅう	Denryu	固有名詞	
きれいはな	Kireihana	固有名詞	
まりる	Maril	固有名詞	
まりるり	Marilli	固有名詞	
うそっきー	Usokkie	固有名詞	
にょろとの	Nyorotono	固有名詞	
はねっこ	Hanecco	固有名詞	
ぽぽっこ	Popocco	固有名詞	
わたっこ	Watacco	固有名詞	
えいぱむ	Eipam	固有名詞	
ひまなっつ	Himanuts	固有名詞	
きまわり	Kimawari	固有名詞	
やんやんま	Yanyanma	固有名詞	
うぱー	Upah	固有名詞	
ぬおー	Nuoh	固有名詞	
えーふぃ	Eifie	固有名詞	
ぶらっきー	Bracky	固有名詞	
やみからす	Yamikarasu	固有名詞	
やどきんぐ	Yadoking	固有名詞	
むうま	Muma	固有名詞	
あんのーん	Unknown	固有名詞	
そーなんす	Sonans	固有名詞	
きりんりき	Kirinriki	固有名詞	
くぬぎだま	Kunugidama	固有名詞	
ふぉれとす	Foretos	固有名詞	
のこっち	Nokocchi	固有名詞	
ぐらいがー	Gliger	固有名詞	
はがねーる	Haganeil	固有名詞	
ぶるー	Bulu	固有名詞	
ぐらんぶる	Granbulu	固有名詞	
はりーせん	Harysen	固有名詞	
はっさむ	Hassam	固有名詞	
つぼつぼ	Tsubotsubo	固有名詞	
へらくろす	Heracros	固有名詞	
にゅーら	Nyula	固有名詞	
ひめぐま	Himeguma	固有名詞	
りんぐま	Ringuma	固有名詞	
まぐまっぐ	Magmag	固有名詞	
まぐかるご	Magcargot	固有名詞	
うりむー	Urimoo	固有名詞	
いのむー	Inomoo	固有名詞	
さにーご	Sunnygo	固有名詞	
てっぽうお	Teppouo	固有名詞	
おくたん	Okutank	固有名詞	
でりばーど	Delibird	固有名詞	
まんたいん	Mantain	固有名詞	
えあーむど	Airmd	固有名詞	
でるびる	Delvil	固有名詞	
へるがー	Hellgar	固有名詞	
きんぐどら	Kingdra	固有名詞	
ごまぞう	Gomazou	固有名詞	
どんふぁん	Donfan	固有名詞	
ぽりごん2	Porygon2	固有名詞	
おどしし	Odoshishi	固有名詞	
どーぶる	Doble	固有名詞	
ばるきー	Balkie	固有名詞	
かぽえらー	Kapoerer	固有名詞	
むちゅーる	Muchul	固有名詞	
えれきっど	Elekid	固有名詞	
ぶびぃ	Buby	固有名詞	
みるたんく	Miltank	固有名詞	
はぴなす	Happinas	固有名詞	
らいこう	Raikou	固有名詞	
えんてい	Entei	固有名詞	
すいくん	Suicune	固有名詞	
よーぎらす	Yogiras	固有名詞	
さなぎらす	Sanagiras	固有名詞	
ばんぎらす	Bangiras	固有名詞	
るぎあ	Lugia	固有名詞	
ほうおう	Houou	固有名詞	
せれびぃ	Celebi	固有名詞	
きもり	Kimori	固有名詞	
じゅぷとる	Juptile	固有名詞	
じゅかいん	Jukain	固有名詞	
あちゃも	Achamo	固有名詞	
わかしゃも	Wakasyamo	固有名詞	
ばしゃーも	Bursyamo	固有名詞	
みずごろう	Mizugorou	固有名詞	
ぬまくろー	Numacraw	固有名詞	
らぐらーじ	Laglarge	固有名詞	
ぽちえな	Pochiena	固有名詞	
ぐらえな	Graena	固有名詞	
じぐざぐま	Jiguzaguma	固有名詞	
まっすぐま	Massuguma	固有名詞	
けむっそ	Kemusso	固有名詞	
からさりす	Karasalis	固有名詞	
あげはんと	Agehunt	固有名詞	
まゆるど	Mayuld	固有名詞	
どくけいる	Dokucale	固有名詞	
はすぼー	Hassboh	固有名詞	
はすぶれろ	Hasubrero	固有名詞	
るんぱっぱ	Runpappa	固有名詞	
たねぼー	Taneboh	固有名詞	
このはな	Konohana	固有名詞	
だーてんぐ	Dirteng	固有名詞	
すばめ	Subame	固有名詞	
おおすばめ	Ohsubame	固有名詞	
きゃもめ	Camome	固有名詞	
ぺりっぱー	Pelipper	固有名詞	
らるとす	Ralts	固有名詞	
きるりあ	Kirlia	固有名詞	
さーないと	Sirnight	固有名詞	
あめたま	Ametama	固有名詞	
あめもーす	Amemoth	固有名詞	
きのここ	Kinococo	固有名詞	
きのがっさ	Kinogassa	固有名詞	
なまけろ	Namakero	固有名詞	
やるきもの	Yarukimono	固有名詞	
けっきんぐ	Kekking	固有名詞	
つちにん	Tutinin	固有名詞	
てっかにん	Tekkanin	固有名詞	
ぬけにん	Nukenin	固有名詞	
ごにょにょ	Gonyonyo	固有名詞	
どごーむ	Dogohmb	固有名詞	
ばくおんぐ	Bakuong	固有名詞	
まくのした	Makunoshita	固有名詞	
はりてやま	Hariteyama	固有名詞	
るりり	Ruriri	固有名詞	
のずぱす	Nosepass	固有名詞	
えねこ	Eneco	固有名詞	
えねころろ	Enekororo	固有名詞	
やみらみ	Yamirami	固有名詞	
くちーと	Kucheat	固有名詞	
ここどら	Cokodora	固有名詞	
こどら	Kodora	固有名詞	
ぼすごどら	Bossgodora	固有名詞	
あさなん	Asanan	固有名詞	
ちゃーれむ	Charem	固有名詞	
らくらい	Rakurai	固有名詞	
らいぼると	Livolt	固有名詞	
ぷらする	Prasle	固有名詞	
まいなん	Minun	固有名詞	
ばるびーと	Barubeat	固有名詞	
いるみーぜ	Illumise	固有名詞	
ろぜりあ	Roselia	固有名詞	
ごくりん	Gokulin	固有名詞	
まるのーむ	Marunoom	固有名詞	
きばにあ	Kibanha	固有名詞	
さめはだー	Samehader	固有名詞	
ほえるこ	Hoeruko	固有名詞	
ほえるおー	Whaloh	固有名詞	
どんめる	Donmel	固有名詞	
ばくーだ	Bakuuda	固有名詞	
こーたす	Cotoise	固有名詞	
ばねぶー	Baneboo	固有名詞	
ぶーぴっぐ	Boopig	固有名詞	
ぱっちーる	Patcheel	固有名詞	
なっくらー	Nuckrar	固有名詞	
びぶらーば	Vibrava	固有名詞	
ふらいごん	Flygon	固有名詞	
さぼねあ	Sabonea	固有名詞	
のくたす	Noctus	固有名詞	
ちるっと	Tyltto	固有名詞	
ちるたりす	Tyltalis	固有名詞	
ざんぐーす	Zangoose	固有名詞	
はぶねーく	Habunake	固有名詞	
るなとーん	Lunatone	固有名詞	
そるろっく	Solrock	固有名詞	
どじょっち	Dojoach	固有名詞	
なまずん	Namazun	固有名詞	
へいがに	Heigani	固有名詞	
しざりがー	Shizariger	固有名詞	
やじろん	Yajilon	固有名詞	
ねんどーる	Nendoll	固有名詞	
りりーら	Lilyla	固有名詞	
ゆれいどる	Yuradle	固有名詞	
あのぷす	Anopth	固有名詞	
あーまるど	Armaldo	固有名詞	
ひんばす	Hinbass	固有名詞	
みろかろす	Milokaross	固有名詞	
ぽわるん	Powalen	固有名詞	
かくれおん	Kakureon	固有名詞	
かげぼうず	Kagebouzu	固有名詞	
じゅぺった	Juppeta	固有名詞	
よまわる	Yomawaru	固有名詞	
さまよーる	Samayouru	固有名詞	
とろぴうす	Tropius	固有名詞	
ちりーん	Chirean	固有名詞	
あぶそる	Absol	固有名詞	
そーなの	Sohnano	固有名詞	
ゆきわらし	Yukiwarashi	固有名詞	
おにごーり	Onigohri	固有名詞	
たまざらし	Tamazarashi	固有名詞	
とどぐらー	Todoggler	固有名詞	
とどぜるが	Todoseruga	固有名詞	
ぱーるる	Pearlulu	固有名詞	
はんてーる	Huntail	固有名詞	
さくらびす	Sakurabyss	固有名詞	
じーらんす	Glanth	固有名詞	
らぶかす	Lovecus	固有名詞	
たつべい	Tatsubay	固有名詞	
こもるー	Komoruu	固有名詞	
ぼーまんだ	Bohmander	固有名詞	
だんばる	Dumbber	固有名詞	
めたんぐ	Metang	固有名詞	
めたぐろす	Metagross	固有名詞	
れじろっく	Regirock	固有名詞	
れじあいす	Regice	固有名詞	
れじすちる	Registeel	固有名詞	
らてぃあす	Latias	固有名詞	
らてぃおす	Latios	固有名詞	
かいおーが	Kyogre	固有名詞	
ぐらーどん	Groudon	固有名詞	
れっくうざ	Rayquaza	固有名詞	
じらーち	Jirachi	固有名詞	
でおきしす	Deoxys	固有名詞	
なえとる	Naetle	固有名詞	
はやしがめ	Hayashigame	固有名詞	
どだいとす	Dodaitose	固有名詞	
ひこざる	Hikozaru	固有名詞	
もうかざる	Moukazaru	固有名詞	
ごうかざる	Goukazaru	固有名詞	
ぽっちゃま	Pochama	固有名詞	
ぽったいし	Pottaishi	固有名詞	
えんぺると	Emperte	固有名詞	
むっくる	Mukkuru	固有名詞	
むくばーど	Mukubird	固有名詞	
むくほーく	Mukuhawk	固有名詞	
びっぱ	Bippa	固有名詞	
びーだる	Beadaru	固有名詞	
ころぼーし	Korobohshi	固有名詞	
ころとっく	Korotock	固有名詞	
こりんく	Kolink	固有名詞	
るくしお	Luxio	固有名詞	
れんとらー	Rentorar	固有名詞	
すぼみー	Subomie	固有名詞	
ろずれいど	Roserade	固有名詞	
ずがいどす	Zugaidos	固有名詞	
らむぱるど	Rampald	固有名詞	
たてとぷす	Tatetops	固有名詞	
とりでぷす	Torideps	固有名詞	
みのむっち	Minomucchi	固有名詞	
みのまだむ	Minomadam	固有名詞	
がーめいる	Gamale	固有名詞	
みつはにー	Mitsuhoney	固有名詞	
びーくいん	Beequen	固有名詞	
ぱちりす	Pachirisu	固有名詞	
ぶいぜる	Buoysel	固有名詞	
ふろーぜる	Floazel	固有名詞	
ちぇりんぼ	Cherinbo	固有名詞	
ちぇりむ	Cherrim	固有名詞	
からなくし	Karanakushi	固有名詞	
とりとどん	Tritodon	固有名詞	
えてぼーす	Eteboth	固有名詞	
ふわんて	Fuwante	固有名詞	
ふわらいど	Fuwaride	固有名詞	
みみろる	Mimirol	固有名詞	
みみろっぷ	Mimilop	固有名詞	
むうまーじ	Mumargi	固有名詞	
どんからす	Dongkarasu	固有名詞	
にゃるまー	Nyarmar	固有名詞	
ぶにゃっと	Bunyatto	固有名詞	
りーしゃん	Lisyan	固有名詞	
すかんぷー	Skunpuu	固有名詞	
すかたんく	Skutank	固有名詞	
どーみらー	Dohmirror	固有名詞	
どーたくん	Dohtakun	固有名詞	
うそはち	Usohachi	固有名詞	
まねね	Manene	固有名詞	
ぴんぷく	Pinpuku	固有名詞	
ぺらっぷ	Perap	固有名詞	
みかるげ	Mikaruge	固有名詞	
ふかまる	Fukamaru	固有名詞	
がばいと	Gabite	固有名詞	
がぶりあす	Gaburias	固有名詞	
ごんべ	Gonbe	固有名詞	
りおる	Riolu	固有名詞	
るかりお	Lucario	固有名詞	
ひぽぽたす	Hippopotas	固有名詞	
かばるどん	Kabaldon	固有名詞	
すこるぴ	Scorupi	固有名詞	
どらぴおん	Dorapion	固有名詞	
ぐれっぐる	Gureggru	固有名詞	
どくろっぐ	Dokurog	固有名詞	
ますきっぱ	Muskippa	固有名詞	
けいこうお	Keikouo	固有名詞	
ねおらんと	Neolant	固有名詞	
たまんた	Tamanta	固有名詞	
ゆきかぶり	Yukikaburi	固有名詞	
ゆきのおー	Yukinooh	固有名詞	
まにゅーら	Manyula	固有名詞	
じばこいる	Jibacoil	固有名詞	
べろべると	Berobelt	固有名詞	
どさいどん	Dosidon	固有名詞	
もじゃんぼ	Mojumbo	固有名詞	
えれきぶる	Elekible	固有名詞	
ぶーばーん	Booburn	固有名詞	
とげきっす	Togekiss	固有名詞	
めがやんま	Megayanma	固有名詞	
りーふぃあ	Leafia	固有名詞	
ぐれいしあ	Glacia	固有名詞	
ぐらいおん	Glion	固有名詞	
まんむー	Mammoo	固有名詞	
ぽりごんぜっと	Porygon-Z	固有名詞	
えるれいど	Erureido	固有名詞	
だいのーず	Dainose	固有名詞	
よのわーる	Yonoir	固有名詞	
ゆきめのこ	Yukimenoko	固有名詞	
ろとむ	Rotom	固有名詞	
ゆくしー	Yuxie	固有名詞	
えむりっと	Emrit	固有名詞	
あぐのむ	Agnome	固有名詞	
でぃあるが	Dialga	固有名詞	
ぱるきあ	Palkia	固有名詞	
ひーどらん	Heatran	固有名詞	
れじぎがす	Regigigas	固有名詞	
ぎらてぃな	Giratina	固有名詞	
くれせりあ	Cresselia	固有名詞	
ふぃおね	Phione	固有名詞	
まなふぃ	Manaphy	固有名詞	
だーくらい	Darkrai	固有名詞	
しぇいみ	Shaymin	固有名詞	
あるせうす	Arceus	固有名詞	
びくてぃに	Victini	固有名詞	
つたーじゃ	Tsutarja	固有名詞	
じゃのびー	Janovy	固有名詞	
じゃろーだ	Jalorda	固有名詞	
ぽかぶ	Pokabu	固有名詞	
ちゃおぶー	Chaoboo	固有名詞	
えんぶおー	Enbuoh	固有名詞	
みじゅまる	Mijumaru	固有名詞	
ふたちまる	Futachimaru	固有名詞	
だいけんき	Daikenki	固有名詞	
みねずみ	Minezumi	固有名詞	
みるほっぐ	Miruhog	固有名詞	
よーてりー	Yorterrie	固有名詞	
はーでりあ	Herderrie	固有名詞	
むーらんど	Mooland	固有名詞	
ちょろねこ	Choroneko	固有名詞	
れぱるだす	Lepardas	固有名詞	
やなっぷ	Yanappu	固有名詞	
やなっきー	Yanakkie	固有名詞	
ばおっぷ	Baoppu	固有名詞	
ばおっきー	Baokkie	固有名詞	
ひやっぷ	Hiyappu	固有名詞	
ひやっきー	Hiyakkie	固有名詞	
むんな	Munna	固有名詞	
むしゃーな	Musharna	固有名詞	
まめぱと	Mamepato	固有名詞	
はとーぼー	Hatoboh	固有名詞	
けんほろう	Kenhallow	固有名詞	
しまま	Shimama	固有名詞	
ぜぶらいか	Zebraika	固有名詞	
だんごろ	Dangoro	固有名詞	
がんとる	Gantle	固有名詞	
ぎがいあす	Gigaiath	固有名詞	
ころもり	Koromori	固有名詞	
こころもり	Kokoromori	固有名詞	
もぐりゅー	Mogurew	固有名詞	
どりゅうず	Doryuzu	固有名詞	
たぶんね	Tabunne	固有名詞	
どっこらー	Dokkorer	固有名詞	
どてっこつ	Dotekkotsu	固有名詞	
ろーぶしん	Roubushin	固有名詞	
おたまろ	Otamaro	固有名詞	
がまがる	Gamagaru	固有名詞	
がまげろげ	Gamageroge	固有名詞	
なげき	Nageki	固有名詞	
だげき	Dageki	固有名詞	
くるみる	Kurumiru	固有名詞	
くるまゆ	Kurumayu	固有名詞	
ははこもり	Hahakomori	固有名詞	
ふしで	Fushide	固有名詞	
ほいーが	Wheega	固有名詞	
ぺんどらー	Pendror	固有名詞	
もんめん	Monmen	固有名詞	
えるふーん	Elfuun	固有名詞	
ちゅりね	Churine	固有名詞	
どれでぃあ	Dredear	固有名詞	
ばすらお	Bassrao	固有名詞	
めぐろこ	Meguroco	固有名詞	
わるびる	Waruvile	固有名詞	
わるびある	Waruvial	固有名詞	
だるまっか	Darumakka	固有名詞	
ひひだるま	Hihidaruma	固有名詞	
まらかっち	Maracacchi	固有名詞	
いしずまい	Ishizumai	固有名詞	
いわぱれす	Iwapalace	固有名詞	
ずるっぐ	Zuruggu	固有名詞	
ずるずきん	Zuruzukin	固有名詞	
しんぼらー	Symboler	固有名詞	
ですます	Desumasu	固有名詞	
ですかーん	Desukarn	固有名詞	
ぷろとーが	Protoga	固有名詞	
あばごーら	Abagoura	固有名詞	
あーけん	Archen	固有名詞	
あーけおす	Archeos	固有名詞	
やぶくろん	Yabukuron	固有名詞	
だすとだす	Dustdas	固有名詞	
ぞろあ	Zorua	固有名詞	
ぞろあーく	Zoroark	固有名詞	
ちらーみぃ	Chillarmy	固有名詞	
ちらちーの	Chillaccino	固有名詞	
ごちむ	Gothimu	固有名詞	
ごちみる	Gothimiru	固有名詞	
ごちるぜる	Gothiruselle	固有名詞	
ゆにらん	Uniran	固有名詞	
だぶらん	Doublan	固有名詞	
らんくるす	Lanculus	固有名詞	
こあるひー	Koaruhie	固有名詞	
すわんな	Swanna	固有名詞	
ばにぷっち	Vanipeti	固有名詞	
ばにりっち	Vanirich	固有名詞	
ばいばにら	Baivanilla	固有名詞	
しきじか	Shikijika	固有名詞	
めぶきじか	Mebukijika	固有名詞	
えもんが	Emonga	固有名詞	
かぶるも	Kaburumo	固有名詞	
しゅばるご	Chevargo	固有名詞	
たまげたけ	Tamagetake	固有名詞	
もろばれる	Morobareru	固有名詞	
ぷるりる	Pururill	固有名詞	
ぶるんげる	Burungel	固有名詞	
ままんぼう	Mamanbou	固有名詞	
ばちゅる	Bachuru	固有名詞	
でんちゅら	Dentula	固有名詞	
てっしーど	Tesseed	固有名詞	
なっとれい	Nutrey	固有名詞	
ぎある	Giaru	固有名詞	
ぎぎある	Gigiaru	固有名詞	
ぎぎぎある	Gigigiaru	固有名詞	
しびしらす	Shibishirasu	固有名詞	
しびびーる	Shibibeel	固有名詞	
しびるどん	Shibirudon	固有名詞	
りぐれー	Ligray	固有名詞	
おーべむ	Ohbem	固有名詞	
ひともし	Hitomoshi	固有名詞	
らんぷらー	Lampler	固有名詞	
しゃんでら	Chandela	固有名詞	
きばご	Kibago	固有名詞	
おのんど	Onondo	固有名詞	
おののくす	Ononokus	固有名詞	
くましゅん	Kumasyun	固有名詞	
つんべあー	Tunbear	固有名詞	
ふりーじお	Freegeo	固有名詞	
ちょぼまき	Chobomaki	固有名詞	
あぎるだー	Agilder	固有名詞	
まっぎょ	Maggyo	固有名詞	
こじょふー	Kojofu	固有名詞	
こじょんど	Kojondo	固有名詞	
くりむがん	Crimgan	固有名詞	
ごびっと	Gobit	固有名詞	
ごるーぐ	Goloog	固有名詞	
こまたな	Komatana	固有名詞	
きりきざん	Kirikizan	固有名詞	
ばっふろん	Buffron	固有名詞	
わしぼん	Washibon	固有名詞	
うぉーぐる	Warrgle	固有名詞	
ばるちゃい	Valchai	固有名詞	
ばるじーな	Vulgina	固有名詞	
くいたらん	Kuitaran	固有名詞	
あいあんと	Aiant	固有名詞	
ものず	Monozu	固有名詞	
じへっど	Dihead	固有名詞	
さざんどら	Sazandora	固有名詞	
めらるば	Merlarva	固有名詞	
うるがもす	Ulgamoth	固有名詞	
こばるおん	Cobalon	固有名詞	
てらきおん	Terrakion	固有名詞	
びりじおん	Virizion	固有名詞	
とるねろす	Tornelos	固有名詞	
ぼるとろす	Voltolos	固有名詞	
れしらむ	Reshiram	固有名詞	
ぜくろむ	Zekrom	固有名詞	
らんどろす	Landlos	固有名詞	
きゅれむ	Kyurem	固有名詞	
けるでぃお	Keldeo	固有名詞	
めろえった	Meloetta	固有名詞	
げのせくと	Genesect	固有名詞	
はりまろん	Harimaron	固有名詞	
はりぼーぐ	Hariborg	固有名詞	
ぶりがろん	Brigarron	固有名詞	
ふぉっこ	Fokko	固有名詞	
てーるなー	Tairenar	固有名詞	
まふぉくしー	Mahoxy	固有名詞	
けろまつ	Keromatsu	固有名詞	
げこがしら	Gekogashira	固有名詞	
げっこうが	Gekkouga	固有名詞	
ほるびー	Horubee	固有名詞	
ほるーど	Horudo	固有名詞	
ややこま	Yayakoma	固有名詞	
ひのやこま	Hinoyakoma	固有名詞	
ふぁいあろー	Fiarrow	固有名詞	
こふきむし	Kofukimushi	固有名詞	
こふーらい	Kofuurai	固有名詞	
びびよん	Viviyon	固有名詞	
ししこ	Shishiko	固有名詞	
かえんじし	Kaenjishi	固有名詞	
ふらべべ	Flabebe	固有名詞	
ふらえって	Floette	固有名詞	
ふらーじぇす	Florges	固有名詞	
めぇーくる	Meecle	固有名詞	
ごーごーと	Gogoat	固有名詞	
やんちゃむ	Yancham	固有名詞	
ごろんだ	Goronda	固有名詞	
とりみあん	Trimmien	固有名詞	
にゃすぱー	Nyasper	固有名詞	
にゃおにくす	Nyaonix	固有名詞	
ひとつき	Hitotsuki	固有名詞	
にだんぎる	Nidangill	固有名詞	
ぎるがるど	Gillgard	固有名詞	
しゅしゅぷ	Shushupu	固有名詞	
ふれふわん	Frefuwan	固有名詞	
ぺろっぱふ	Peroppafu	固有名詞	
ぺろりーむ	Peroream	固有名詞	
まーいーか	Maaiika	固有名詞	
からまねろ	Calamanero	固有名詞	
かめてて	Kametete	固有名詞	
がめのです	Gamenodes	固有名詞	
くずもー	Kuzumo	固有名詞	
どらみどろ	Dramidoro	固有名詞	
うでっぽう	Udeppou	固有名詞	
ぶろすたー	Bloster	固有名詞	
えりきてる	Erikiteru	固有名詞	
えれざーど	Elezard	固有名詞	
ちごらす	Chigoras	固有名詞	
がちごらす	Gachigoras	固有名詞	
あまるす	Amarus	固有名詞	
あまるるが	Amaruruga	固有名詞	
にんふぃあ	Nymphia	固有名詞	
るちゃぶる	Luchabull	固有名詞	
ででんね	Dedenne	固有名詞	
めれしー	Melecie	固有名詞	
ぬめら	Numera	固有名詞	
ぬめいる	Numeil	固有名詞	
ぬめるごん	Numelgon	固有名詞	
くれっふぃ	Cleffy	固有名詞	
ぼくれー	Bokurei	固有名詞	
おーろっと	Ohrot	固有名詞	
ばけっちゃ	Bakeccha	固有名詞	
ぱんぷじん	Pumpjin	固有名詞	
かちこーる	Kachikohru	固有名詞	
くれべーす	Crebase	固有名詞	
おんばっと	Onbat	固有名詞	
おんばーん	Onvern	固有名詞	
ぜるねあす	Xerneas	固有名詞	
いべるたる	Yveltal	固有名詞	
じがるで	Zygarde	固有名詞	
でぃあんしー	Diancie	固有名詞	
ふーぱ	Hoopa	固有名詞	
ぼるけにおん	Volcanion	固有名詞	
もくろー	Mokuroh	固有名詞	
ふくすろー	Fukuthrow	固有名詞	
じゅないぱー	Junaiper	固有名詞	
にゃびー	Nyabby	固有名詞	
にゃひーと	Nyaheat	固有名詞	
がおがえん	Gaogaen	固有名詞	
あしまり	Ashimari	固有名詞	
おしゃまり	Osyamari	固有名詞	
あしれーぬ	Ashirene	固有名詞	
つつけら	Tsutsukera	固有名詞	
けららっぱ	Kerarappa	固有名詞	
どでかばし	Dodekabashi	固有名詞	
やんぐーす	Youngoose	固有名詞	
でかぐーす	Dekagoose	固有名詞	
あごじむし	Agojimushi	固有名詞	
でんぢむし	Dendimushi	固有名詞	
くわがのん	Kuwagannon	固有名詞	
まけんかに	Makenkani	固有名詞	
けけんかに	Kekenkani	固有名詞	
おどりどり	Odoridori	固有名詞	
あぶりー	Abuly	固有名詞	
あぶりぼん	Aburibbon	固有名詞	
いわんこ	Iwanko	固有名詞	
るがるがん	Lugarugan	固有名詞	
よわし	Yowashi	固有名詞	
ひどいで	Hidoide	固有名詞	
どひどいで	Dohidoide	固有名詞	
どろばんこ	Dorobanko	固有名詞	
ばんばどろ	Banbadoro	固有名詞	
しずくも	Shizukumo	固有名詞	
おにしずくも	Onishizukumo	固有名詞	
かりきり	Karikiri	固有名詞	
ららんてす	Lalantes	固有名詞	
ねましゅ	Nemasyu	固有名詞	
ましぇーど	Mashade	固有名詞	
やとうもり	Yatoumori	固有名詞	
えんにゅーと	Ennewt	固有名詞	
ぬいこぐま	Nuikoguma	固有名詞	
きてるぐま	Kiteruguma	固有名詞	
あまかじ	Amakaji	固有名詞	
あままいこ	Amamaiko	固有名詞	
あまーじょ	Amajo	固有名詞	
きゅわわー	Cuwawa	固有名詞	
やれゆーたん	Yareyuutan	固有名詞	
なげつけさる	Nagetukesaru	固有名詞	
こそくむし	Kosokumushi	固有名詞	
ぐそくむしゃ	Gusokumusha	固有名詞	
すなばぁ	Sunaba	固有名詞	
しろですな	Sirodethna	固有名詞	
なまこぶし	Namakobushi	固有名詞	
たいぷ:ぬる	Type: Null	固有名詞	
しるゔぁでぃ	Silvady	固有名詞	
めての	Meteno	固有名詞	
ねっこあら	Nekkoara	固有名詞	
ばくがめす	Bakugames	固有名詞	
とげでまる	Togedemaru	固有名詞	
みみっきゅ	Mimikkyu	固有名詞	
はぎぎしり	Hagigishiri	固有名詞	
じじーろん	Jijilong	固有名詞	
だだりん	Dadarin	固有名詞	
じゃらこ	Jyarako	固有名詞	
じゃらんご	Jyarango	固有名詞	
じゃららんが	Jyararanga	固有名詞	
かぷ・こけこ	Kapu-Kokeko	固有名詞	
かぷ・ててふ	Kapu-Tetefu	固有名詞	
かぷ・ぶるる	Kapu-Bulul	固有名詞	
かぷ・れひれ	Kapu-Rehire	固有名詞	
こすもっぐ	Cosmog	固有名詞	
こすもうむ	Cosmovum	固有名詞	
そるがれお	Solgaleo	固有名詞	
るなあーら	Lunala	固有名詞	
うつろいど	Uturoid	固有名詞	
まっしぶーん	Massivoon	固有名詞	
ふぇろーちぇ	Pheroache	固有名詞	
でんじゅもく	Denjyumoku	固有名詞	
てっかぐや	Tekkaguya	固有名詞	
かみつるぎ	Kamiturugi	固有名詞	
あくじきんぐ	Akuziking	固有名詞	
ねくろずま	Necrozma	固有名詞	
まぎあな	Magearna	固有名詞	
まーしゃどー	Marshadow	固有名詞	
べべのむ	Bevenom	固有名詞	
あーごよん	Agoyon	固有名詞	
つんでつんで	Tundetunde	固有名詞	
ずがどーん	Zugadoon	固有名詞	
ぜらおら	Zeraora	固有名詞	
めるたん	Meltan	固有名詞	
めるめたる	Melmetal	固有名詞	
さるのり	Sarunori	固有名詞	
ばちんきー	Bachinkey	固有名詞	
ごりらんだー	Gorirander	固有名詞	
ひばにー	Hibanny	固有名詞	
らびふっと	Rabbifuto	固有名詞	
えーすばーん	Aceburn	固有名詞	
めっそん	Messon	固有名詞	
じめれおん	Jimereon	固有名詞	
いんてれおん	Intereon	固有名詞	
ほしがりす	Hoshigarisu	固有名詞	
よくばりす	Yokubarisu	固有名詞	
ここがら	Kokogara	固有名詞	
あおがらす	Aogarasu	固有名詞	
あーまーがあ	Armorga	固有名詞	
さっちむし	Sacchimushi	固有名詞	
れどーむし	Redomushi	固有名詞	
いおるぶ	Eolb	固有名詞	
くすね	Kusune	固有名詞	
ふぉくすらい	Foxly	固有名詞	
ひめんか	Himenka	固有名詞	
わたしらが	Watashiraga	固有名詞	
うーるー	Wooluu	固有名詞	
ばいうーるー	Baiwooluu	固有名詞	
かむかめ	Kamukame	固有名詞	
かじりがめ	Kajirigame	固有名詞	
わんぱち	Wanpachi	固有名詞	
ぱるすわん	Pulsewan	固有名詞	
たんどん	Tandon	固有名詞	
とろっごん	Toroggon	固有名詞	
せきたんざん	Sekitanzan	固有名詞	
かじっちゅ	Kajicchu	固有名詞	
あっぷりゅー	Appryu	固有名詞	
たるっぷる	Tarupple	固有名詞	
すなへび	Sunahebi	固有名詞	
さだいじゃ	Sadaija	固有名詞	
うっう	Uu	固有名詞	
さしかます	Sasikamasu	固有名詞	
かますじょー	Kamasujaw	固有名詞	
えれずん	Eleson	固有名詞	
すとりんだー	Strinder	固有名詞	
やくで	Yakude	固有名詞	
まるやくで	Maruyakude	固有名詞	
たたっこ	Tatakko	固有名詞	
おとすぱす	Otosupus	固有名詞	
やばちゃ	Yabacha	固有名詞	
ぽっとです	Potdeath	固有名詞	
みぶりむ	Mibrim	固有名詞	
てぶりむ	Tebrim	固有名詞	
ぶりむおん	Brimuon	固有名詞	
べろばー	Beroba	固有名詞	
ぎもー	Gimoh	固有名詞	
おーろんげ	Ohlonge	固有名詞	
たちふさぐま	Tachifusaguma	固有名詞	
にゃいきんぐ	Nyaiking	固有名詞	
さにごーん	Sunigoon	固有名詞	
ねぎがないと	Negigaknight	固有名詞	
ばりこおる	Barrikohru	固有名詞	
ですばーん	Deathbarn	固有名詞	
まほみる	Mahomil	固有名詞	
まほいっぷ	Mawhip	固有名詞	
たいれーつ	Tairetsu	固有名詞	
ばちんうに	Bachinuni	固有名詞	
ゆきはみ	Yukihami	固有名詞	
もすのう	Mothnow	固有名詞	
いしへんじん	Ishihengin	固有名詞	
こおりっぽ	Korippo	固有名詞	
いえっさん	Yessan	固有名詞	
もるぺこ	Morpeko	固有名詞	
ぞうどう	Zoudou	固有名詞	
だいおうどう	Daioudou	固有名詞	
ぱっちらごん	Patchiragon	固有名詞	
ぱっちるどん	Patchilldon	固有名詞	
うおのらごん	Uonoragon	固有名詞	
うおちるどん	Uochilldon	固有名詞	
じゅらるどん	Duraludon	固有名詞	
どらめしや	Dorameshiya	固有名詞	
どろんち	Doronch	固有名詞	
どらぱると	Dorapult	固有名詞	
ざしあん	Zacian	固有名詞	
ざまぜんた	Zamazenta	固有名詞	
むげんだいな	Mugendina	固有名詞	
だくま	Dakuma	固有名詞	
うーらおす	Wulaosu	固有名詞	
ざるーど	Zarude	固有名詞	
れじえれき	Regieleki	固有名詞	
れじどらご	Regidorago	固有名詞	
ぶりざぽす	Blizzapos	固有名詞	
れいすぽす	Wraithpos	固有名詞	
ばどれっくす	Budrex	固有名詞	
あやしし	Ayashishi	固有名詞	
ばさぎり	Basagiri	固有名詞	
がちぐま	Gachiguma	固有名詞	
いだいとう	Idaitou	固有名詞	
おおにゅーら	Ohnyula	固有名詞	
はりーまん	Haryman	固有名詞	
らぶとろす	Lovetolos	固有名詞	
にゃおは	Nyahoja	固有名詞	
にゃろーて	Nyarote	固有名詞	
ますかーにゃ	Masquernya	固有名詞	
ほげーた	Hogator	固有名詞	
あちげーた	Achigator	固有名詞	
らうどぼーん	Laudbon	固有名詞	
くわっす	Kuwassu	固有名詞	
うぇるかも	Welkamo	固有名詞	
うぇーにばる	Wanival	固有名詞	
ぐるとん	Gourton	固有名詞	
ぱふゅーとん	Perfuton	固有名詞	
たまんちゅら	Tamantula	固有名詞	
わないだー	Wanaider	固有名詞	
まめばった	Mamebatta	固有名詞	
えくすれっぐ	Exleg	固有名詞	
ぱも	Pamo	固有名詞	
ぱもっと	Pamot	固有名詞	
ぱーもっと	Parmot	固有名詞	
わっかねずみ	Wakkanezumi	固有名詞	
いっかねずみ	Ikkanezumi	固有名詞	
ぱぴもっち	Pupimocchi	固有名詞	
ばうっつぇる	Bowtzel	固有名詞	
みにーぶ	Minive	固有名詞	
おりーにょ	Olinyo	固有名詞	
おりーゔぁ	Oliva	固有名詞	
いきりんこ	Ikirinko	固有名詞	
こじお	Kojio	固有名詞	
じおづむ	Jiodumu	固有名詞	
きょじおーん	Kyojiohn	固有名詞	
かるぼう	Carbou	固有名詞	
ぐれんあるま	Gurenarma	固有名詞	
そうぶれいず	Soublades	固有名詞	
ずぴか	Zupika	固有名詞	
はらばりー	Harabarie	固有名詞	
かいでん	Kaiden	固有名詞	
たいかいでん	Taikaiden	固有名詞	
おらちふ	Orachifu	固有名詞	
まふぃてぃふ	Mafitiff	固有名詞	
しるしゅるー	Shirushrew	固有名詞	
たぎんぐる	Taggingru	固有名詞	
あのくさ	Anokusa	固有名詞	
あのほらぐさ	Anohoragusa	固有名詞	
ののくらげ	Nonokurage	固有名詞	
りくくらげ	Rikukurage	固有名詞	
がけがに	Gakegani	固有名詞	
かぷさいじ	Capsaiji	固有名詞	
すこゔぃらん	Scovillain	固有名詞	
しがろこ	Shigaroko	固有名詞	
べらかす	Beracas	固有名詞	
ひらひな	Hirahina	固有名詞	
くえすぱとら	Cuespatra	固有名詞	
かぬちゃん	Kanuchan	固有名詞	
なかぬちゃん	Nakanuchan	固有名詞	
でかぬちゃん	Dekanuchan	固有名詞	
うみでぃぐだ	Umidigda	固有名詞	
うみとりお	Umitrio	固有名詞	
おとしどり	Otoshidori	固有名詞	
なみいるか	Namiiruka	固有名詞	
いるかまん	Irukaman	固有名詞	
ぶろろん	Buroron	固有名詞	
ぶろろろーむ	Burororoom	固有名詞	
もととかげ	Mototokage	固有名詞	
みみずず	Mimizuzu	固有名詞	
きらーめ	Kirame	固有名詞	
きらふろる	Kiraflor	固有名詞	
ぼち	Bochi	固有名詞	
はかどっぐ	Hakadog	固有名詞	
からみんご	Karamingo	固有名詞	
あるくじら	Arukujira	固有名詞	
はるくじら	Hulkujira	固有名詞	
みがるーさ	Migalusa	固有名詞	
へいらっしゃ	Heyrusher	固有名詞	
しゃりたつ	Syaritatsu	固有名詞	
このよざる	Konoyozaru	固有名詞	
どおー	Dooh	固有名詞	
りききりん	Rikikirin	固有名詞	
のここっち	Nokokocchi	固有名詞	
どどげざん	Dodogezan	固有名詞	
いだいなきば	Idainakiba	固有名詞	
さけぶしっぽ	Sakebushippo	固有名詞	
あらぶるたけ	Araburutake	固有名詞	
はばたくかみ	Habatakukami	固有名詞	
ちをはうはね	Chiwohauhane	固有名詞	
すなのけがわ	Sunanokegawa	固有名詞	
てつのわだち	Tetsunowadachi	固有名詞	
てつのつつみ	Tetsunotsutsumi	固有名詞	
てつのかいな	Tetsunokaina	固有名詞	
てつのこうべ	Tetsunokoube	固有名詞	
てつのどくが	Tetsunodokuga	固有名詞	
てつのいばら	Tetsunoibara	固有名詞	
せびえ	Sebie	固有名詞	
せごーる	Segohru	固有名詞	
せぐれいぶ	Seglaive	固有名詞	
これくれー	Collecurei	固有名詞	
さーふごー	Surfugo	固有名詞	
ちおんじぇん	Chionjen	固有名詞	
ぱおじあん	Paojian	固有名詞	
でぃんるー	Dinlu	固有名詞	
いーゆい	Yiyui	固有名詞	
とどろくつき	Todorokutsuki	固有名詞	
てつのぶじん	Tetsunobujin	固有名詞	
こらいどん	Koraidon	固有名詞	
みらいどん	Miraidon	固有名詞	
うねるみなも	Uneruminamo	固有名詞	
てつのいさは	Tetsunoisaha	固有名詞	
かみっちゅ	Kamicchu	固有名詞	
ちゃです	Chadeath	固有名詞	
やばそちゃ	Yabasocha	固有名詞	
いいねいぬ	Iineinu	固有名詞	
ましましら	Mashimashira	固有名詞	
きちきぎす	Kichikigisu	固有名詞	
おーがぽん	Ogerpon	固有名詞	
ぶりじゅらす	Briduras	固有名詞	
かみつおろち	Kamitsuorochi	固有名詞	
うがつほむら	Ugatsuhomura	固有名詞	
たけるらいこ	Takeruraiko	固有名詞	
てつのいわお	Tetsunoiwao	固有名詞	
てつのかしら	Tetsunokashira	固有名詞	
てらぱごす	Terapagos	固有名詞	
ももわろう	Momowarou	固有名詞	
