あくしゅう	あくしゅう	固有名詞
あめふらし	あめふらし	固有名詞
かそく	かそく	固有名詞
かぶとあーまー	カブトアーマー	固有名詞
がんじょう	がんじょう	固有名詞
しめりけ	しめりけ	固有名詞
じゅうなん	じゅうなん	固有名詞
すながくれ	すながくれ	固有名詞
せいでんき	せいでんき	固有名詞
ちくでん	ちくでん	固有名詞
ちょすい	ちょすい	固有名詞
どんかん	どんかん	固有名詞
のーてんき	ノーてんき	固有名詞
ふくがん	ふくがん	固有名詞
ふみん	ふみん	固有名詞
へんしょく	へんしょく	固有名詞
めんえき	めんえき	固有名詞
もらいび	もらいび	固有名詞
りんぷん	りんぷん	固有名詞
まいぺーす	マイペース	固有名詞
きゅうばん	きゅうばん	固有名詞
いかく	いかく	固有名詞
かげふみ	かげふみ	固有名詞
さめはだ	さめはだ	固有名詞
ふしぎなまもり	ふしぎなまもり	固有名詞
ふゆう	ふゆう	固有名詞
ほうし	ほうし	固有名詞
しんくろ	シンクロ	固有名詞
くりあぼでぃ	クリアボディ	固有名詞
しぜんかいふく	しぜんかいふく	固有名詞
ひらいしん	ひらいしん	固有名詞
てんのめぐみ	てんのめぐみ	固有名詞
すいすい	すいすい	固有名詞
ようりょくそ	ようりょくそ	固有名詞
はっこう	はっこう	固有名詞
とれーす	トレース	固有名詞
ちからもち	ちからもち	固有名詞
どくのとげ	どくのトゲ	固有名詞
せいしんりょく	せいしんりょく	固有名詞
まぐまのよろい	マグマのよろい	固有名詞
みずのべーる	みずのベール	固有名詞
じりょく	じりょく	固有名詞
ぼうおん	ぼうおん	固有名詞
あめうけざら	あめうけざら	固有名詞
すなおこし	すなおこし	固有名詞
ぷれっしゃー	プレッシャー	固有名詞
あついしぼう	あついしぼう	固有名詞
はやおき	はやおき	固有名詞
ほのおのからだ	ほのおのからだ	固有名詞
にげあし	にげあし	固有名詞
するどいめ	するどいめ	固有名詞
かいりきばさみ	かいりきバサミ	固有名詞
ものひろい	ものひろい	固有名詞
なまけ	なまけ	固有名詞
はりきり	はりきり	固有名詞
めろめろぼでぃ	メロメロボディ	固有名詞
ぷらす	プラス	固有名詞
まいなす	マイナス	固有名詞
てんきや	てんきや	固有名詞
ねんちゃく	ねんちゃく	固有名詞
だっぴ	だっぴ	固有名詞
こんじょう	こんじょう	固有名詞
ふしぎなうろこ	ふしぎなうろこ	固有名詞
へどろえき	ヘドロえき	固有名詞
しんりょく	しんりょく	固有名詞
もうか	もうか	固有名詞
げきりゅう	げきりゅう	固有名詞
むしのしらせ	むしのしらせ	固有名詞
いしあたま	いしあたま	固有名詞
ひでり	ひでり	固有名詞
ありじごく	ありじごく	固有名詞
やるき	やるき	固有名詞
しろいけむり	しろいけむり	固有名詞
よがぱわー	ヨガパワー	固有名詞
しぇるあーまー	シェルアーマー	固有名詞
えあろっく	エアロック	固有名詞
ちどりあし	ちどりあし	固有名詞
でんきえんじん	でんきエンジン	固有名詞
とうそうしん	とうそうしん	固有名詞
ふくつのこころ	ふくつのこころ	固有名詞
ゆきがくれ	ゆきがくれ	固有名詞
くいしんぼう	くいしんぼう	固有名詞
いかりのつぼ	いかりのつぼ	固有名詞
かるわざ	かるわざ	固有名詞
たいねつ	たいねつ	固有名詞
たんじゅん	たんじゅん	固有名詞
かんそうはだ	かんそうはだ	固有名詞
だうんろーど	ダウンロード	固有名詞
てつのこぶし	てつのこぶし	固有名詞
ぽいずんひーる	ポイズンヒール	固有名詞
てきおうりょく	てきおうりょく	固有名詞
すきるりんく	スキルリンク	固有名詞
うるおいぼでぃ	うるおいボディ	固有名詞
さんぱわー	サンパワー	固有名詞
はやあし	はやあし	固有名詞
のーまるすきん	ノーマルスキン	固有名詞
すないぱー	スナイパー	固有名詞
まじっくがーど	マジックガード	固有名詞
のーがーど	ノーガード	固有名詞
あとだし	あとだし	固有名詞
てくにしゃん	テクニシャン	固有名詞
りーふがーど	リーフガード	固有名詞
ぶきよう	ぶきよう	固有名詞
かたやぶり	かたやぶり	固有名詞
きょううん	きょううん	固有名詞
ゆうばく	ゆうばく	固有名詞
きけんよち	きけんよち	固有名詞
よちむ	よちむ	固有名詞
てんねん	てんねん	固有名詞
いろめがね	いろめがね	固有名詞
ふぃるたー	フィルター	固有名詞
すろーすたーと	スロースタート	固有名詞
きもったま	きもったま	固有名詞
よびみず	よびみず	固有名詞
あいすぼでぃ	アイスボディ	固有名詞
はーどろっく	ハードロック	固有名詞
ゆきふらし	ゆきふらし	固有名詞
みつあつめ	みつあつめ	固有名詞
おみとおし	おみとおし	固有名詞
すてみ	すてみ	固有名詞
まるちたいぷ	マルチタイプ	固有名詞
ふらわーぎふと	フラワーギフト	固有名詞
ないとめあ	ナイトメア	固有名詞
わるいてぐせ	わるいてぐせ	固有名詞
ちからずく	ちからずく	固有名詞
あまのじゃく	あまのじゃく	固有名詞
きんちょうかん	きんちょうかん	固有名詞
まけんき	まけんき	固有名詞
よわき	よわき	固有名詞
のろわれぼでぃ	のろわれボディ	固有名詞
いやしのこころ	いやしのこころ	固有名詞
ふれんどがーど	フレンドガード	固有名詞
くだけるよろい	くだけるよろい	固有名詞
へヴぃめたる	ヘヴィメタル	固有名詞
らいとめたる	ライトメタル	固有名詞
まるちすけいる	マルチスケイル	固有名詞
どくぼうそう	どくぼうそう	固有名詞
ねつぼうそう	ねつぼうそう	固有名詞
しゅうかく	しゅうかく	固有名詞
てれぱしー	テレパシー	固有名詞
むらっけ	ムラっけ	固有名詞
ぼうじん	ぼうじん	固有名詞
どくしゅ	どくしゅ	固有名詞
さいせいりょく	さいせいりょく	固有名詞
はとむね	はとむね	固有名詞
すなかき	すなかき	固有名詞
みらくるすきん	ミラクルスキン	固有名詞
あならいず	アナライズ	固有名詞
いりゅーじょん	イリュージョン	固有名詞
かわりもの	かわりもの	固有名詞
すりぬけ	すりぬけ	固有名詞
みいら	ミイラ	固有名詞
じしんかじょう	じしんかじょう	固有名詞
せいぎのこころ	せいぎのこころ	固有名詞
びびり	びびり	固有名詞
まじっくみらー	マジックミラー	固有名詞
そうしょく	そうしょく	固有名詞
いたずらごころ	いたずらごころ	固有名詞
すなのちから	すなのちから	固有名詞
てつのとげ	てつのトゲ	固有名詞
だるまもーど	ダルマモード	固有名詞
しょうりのほし	しょうりのほし	固有名詞
たーぼぶれいず	ターボブレイズ	固有名詞
てらぼるてーじ	テラボルテージ	固有名詞
あろまべーる	アロマベール	固有名詞
ふらわーべーる	フラワーベール	固有名詞
ほおぶくろ	ほおぶくろ	固有名詞
へんげんじざい	へんげんじざい	固有名詞
ふぁーこーと	ファーコート	固有名詞
まじしゃん	マジシャン	固有名詞
ぼうだん	ぼうだん	固有名詞
かちき	かちき	固有名詞
がんじょうあご	がんじょうあご	固有名詞
ふりーずすきん	フリーズスキン	固有名詞
すいーとべーる	スイートベール	固有名詞
ばとるすいっち	バトルスイッチ	固有名詞
はやてのつばさ	はやてのつばさ	固有名詞
めがらんちゃー	メガランチャー	固有名詞
くさのけがわ	くさのけがわ	固有名詞
きょうせい	きょうせい	固有名詞
かたいつめ	かたいツメ	固有名詞
ふぇありーすきん	フェアリースキン	固有名詞
ぬめぬめ	ぬめぬめ	固有名詞
すかいすきん	スカイスキン	固有名詞
おやこあい	おやこあい	固有名詞
だーくおーら	ダークオーラ	固有名詞
ふぇありーおーら	フェアリーオーラ	固有名詞
おーらぶれいく	オーラブレイク	固有名詞
はじまりのうみ	はじまりのうみ	固有名詞
おわりのだいち	おわりのだいち	固有名詞
でるたすとりーむ	デルタストリーム	固有名詞
じきゅうりょく	じきゅうりょく	固有名詞
にげごし	にげごし	固有名詞
ききかいひ	ききかいひ	固有名詞
みずがため	みずがため	固有名詞
ひとでなし	ひとでなし	固有名詞
りみっとしーるど	リミットシールド	固有名詞
はりこみ	はりこみ	固有名詞
すいほう	すいほう	固有名詞
はがねつかい	はがねつかい	固有名詞
ぎゃくじょう	ぎゃくじょう	固有名詞
ゆきかき	ゆきかき	固有名詞
えんかく	えんかく	固有名詞
うるおいぼいす	うるおいボイス	固有名詞
ひーりんぐしふと	ヒーリングシフト	固有名詞
えれきすきん	エレキスキン	固有名詞
さーふてーる	サーフテール	固有名詞
ぎょぐん	ぎょぐん	固有名詞
ばけのかわ	ばけのかわ	固有名詞
きずなへんげ	きずなへんげ	固有名詞
すわーむちぇんじ	スワームチェンジ	固有名詞
ふしょく	ふしょく	固有名詞
ぜったいねむり	ぜったいねむり	固有名詞
じょおうのいげん	じょおうのいげん	固有名詞
とびだすなかみ	とびだすなかみ	固有名詞
おどりこ	おどりこ	固有名詞
ばってりー	バッテリー	固有名詞
もふもふ	もふもふ	固有名詞
びびっどぼでぃ	ビビッドボディ	固有名詞
そうるはーと	ソウルハート	固有名詞
かーりーへあー	カーリーヘアー	固有名詞
れしーばー	レシーバー	固有名詞
かがくのちから	かがくのちから	固有名詞
びーすとぶーすと	ビーストブースト	固有名詞
えーあーるしすてむ	ARシステム	固有名詞
えれきめいかー	エレキメイカー	固有名詞
さいこめいかー	サイコメイカー	固有名詞
みすとめいかー	ミストメイカー	固有名詞
ぐらすめいかー	グラスメイカー	固有名詞
めたるぷろてくと	メタルプロテクト	固有名詞
ふぁんとむがーど	ファントムガード	固有名詞
ぷりずむあーまー	プリズムアーマー	固有名詞
ぶれいんふぉーす	ブレインフォース	固有名詞
ふとうのけん	ふとうのけん	固有名詞
ふくつのたて	ふくつのたて	固有名詞
りべろ	リベロ	固有名詞
たまひろい	たまひろい	固有名詞
わたげ	わたげ	固有名詞
すくりゅーおびれ	スクリューおびれ	固有名詞
みらーあーまー	ミラーアーマー	固有名詞
うのみさいる	うのミサイル	固有名詞
すじがねいり	すじがねいり	固有名詞
じょうききかん	じょうききかん	固有名詞
ぱんくろっく	パンクロック	固有名詞
すなはき	すなはき	固有名詞
こおりのりんぷん	こおりのりんぷん	固有名詞
じゅくせい	じゅくせい	固有名詞
あいすふぇいす	アイスフェイス	固有名詞
ぱわーすぽっと	パワースポット	固有名詞
ぎたい	ぎたい	固有名詞
ばりあふりー	バリアフリー	固有名詞
はがねのせいしん	はがねのせいしん	固有名詞
ほろびのぼでぃ	ほろびのボディ	固有名詞
さまようたましい	さまようたましい	固有名詞
ごりむちゅう	ごりむちゅう	固有名詞
かがくへんかがす	かがくへんかガス	固有名詞
ぱすてるべーる	パステルベール	固有名詞
はらぺこすいっち	はらぺこスイッチ	固有名詞
くいっくどろう	クイックドロウ	固有名詞
ふかしのこぶし	ふかしのこぶし	固有名詞
とらんじすた	トランジスタ	固有名詞
りゅうのあぎと	りゅうのあぎと	固有名詞
きみょうなくすり	きみょうなくすり	固有名詞
しろのいななき	しろのいななき	固有名詞
くろのいななき	くろのいななき	固有名詞
じんばいったい	じんばいったい	固有名詞
いかりのこうら	いかりのこうら	固有名詞
いわはこび	いわはこび	固有名詞
おうごんのからだ	おうごんのからだ	固有名詞
おもかげやどし	おもかげやどし	固有名詞
おもてなし	おもてなし	固有名詞
かぜのり	かぜのり	固有名詞
かんろなみつ	かんろなミツ	固有名詞
きょうえん	きょうえん	固有名詞
きよめのしお	きよめのしお	固有名詞
きれあじ	きれあじ	固有名詞
きんしのちから	きんしのちから	固有名詞
くぉーくちゃーじ	クォークチャージ	固有名詞
こだいかっせい	こだいかっせい	固有名詞
こぼれだね	こぼれダネ	固有名詞
こんがりぼでぃ	こんがりボディ	固有名詞
しれいとう	しれいとう	固有名詞
しんがん	しんがん	固有名詞
ゼロふぉーみんぐ	ゼロフォーミング	固有名詞
そうだいしょう	そうだいしょう	固有名詞
ているあーまー	テイルアーマー	固有名詞
てらすしぇる	テラスシェル	固有名詞
てらすちぇんじ	テラスチェンジ	固有名詞
でんきにかえる	でんきにかえる	固有名詞
どくくぐつ	どくくぐつ	固有名詞
どくげしょう	どくげしょう	固有名詞
どくのくさり	どくのくさり	固有名詞
どしょく	どしょく	固有名詞
とれないにおい	とれないにおい	固有名詞
ねつこうかん	ねつこうかん	固有名詞
はどろんえんじん	ハドロンエンジン	固有名詞
ばんけん	ばんけん	固有名詞
はんすう	はんすう	固有名詞
ひひいろのこどう	ひひいろのこどう	固有名詞
びんじょう	びんじょう	固有名詞
ふうりょくでんき	ふうりょくでんき	固有名詞
まいてぃちぇんじ	マイティチェンジ	固有名詞
わざわいのうつわ	わざわいのうつわ	固有名詞
わざわいのおふだ	わざわいのおふだ	固有名詞
わざわいのたま	わざわいのたま	固有名詞
わざわいのつるぎ	わざわいのつるぎ	固有名詞
