ひかりのこな	ひかりのこな	固有名詞
せんせいのつめ	せんせいのツメ	固有名詞
おうじゃのしるし	おうじゃのしるし	固有名詞
ぎんのこな	ぎんのこな	固有名詞
おまもりこばん	おまもりこばん	固有名詞
きよめのおふだ	きよめのおふだ	固有名詞
けむりだま	けむりだま	固有名詞
かわらずのいし	かわらずのいし	固有名詞
きあいのはちまき	きあいのハチマキ	固有名詞
しあわせたまご	しあわせタマゴ	固有名詞
ぴんとれんず	ピントレンズ	固有名詞
めたるこーと	メタルコート	固有名詞
たべのこし	たべのこし	固有名詞
りゅうのうろこ	りゅうのウロコ	固有名詞
でんきだま	でんきだま	固有名詞
やわらかいすな	やわらかいすな	固有名詞
かたいいし	かたいいし	固有名詞
きせきのたね	きせきのタネ	固有名詞
くろいめがね	くろいメガネ	固有名詞
くろおび	くろおび	固有名詞
じしゃく	じしゃく	固有名詞
しんぴのしずく	しんぴのしずく	固有名詞
するどいくちばし	するどいくちばし	固有名詞
どくばり	どくバリ	固有名詞
とけないこおり	とけないこおり	固有名詞
のろいのおふだ	のろいのおふだ	固有名詞
まがったすぷーん	まがったスプーン	固有名詞
もくたん	もくたん	固有名詞
りゅうのきば	りゅうのキバ	固有名詞
ぴんくのりぼん	ピンクのリボン	固有名詞
みずたまりぼん	みずたまリボン	固有名詞
あっぷぐれーど	アップグレード	固有名詞
らっきーぱんち	ラッキーパンチ	固有名詞
めたるぱうだー	メタルパウダー	固有名詞
ふといほね	ふといホネ	固有名詞
ながねぎ	ながねぎ	固有名詞
はかいのいでんし	はかいのいでんし	固有名詞
しろいはーぶ	しろいハーブ	固有名詞
きょうせいぎぷす	きょうせいギプス	固有名詞
やすらぎのすず	やすらぎのすず	固有名詞
めんたるはーぶ	メンタルハーブ	固有名詞
こだわりはちまき	こだわりハチマキ	固有名詞
こころのしずく	こころのしずく	固有名詞
しんかいのきば	しんかいのキバ	固有名詞
しんかいのうろこ	しんかいのウロコ	固有名詞
しるくのすかーふ	シルクのスカーフ	固有名詞
かいがらのすず	かいがらのすず	固有名詞
うしおのおこう	うしおのおこう	固有名詞
のんきのおこう	のんきのおこう	固有名詞
あかいばんだな	あかいバンダナ	固有名詞
あおいばんだな	あおいバンダナ	固有名詞
ぴんくのばんだな	ピンクのバンダナ	固有名詞
みどりのばんだな	みどりのバンダナ	固有名詞
きいろのばんだな	きいろのバンダナ	固有名詞
べにいろのたま	べにいろのたま	固有名詞
あいいろのたま	あいいろのたま	固有名詞
ひのたまぷれーと	ひのたまプレート	固有名詞
しずくぷれーと	しずくプレート	固有名詞
いかずちぷれーと	いかずちプレート	固有名詞
みどりのぷれーと	みどりのプレート	固有名詞
つららのぷれーと	つららのプレート	固有名詞
こぶしのぷれーと	こぶしのプレート	固有名詞
もうどくぷれーと	もうどくプレート	固有名詞
だいちのぷれーと	だいちのプレート	固有名詞
あおぞらぷれーと	あおぞらプレート	固有名詞
ふしぎのぷれーと	ふしぎのプレート	固有名詞
たまむしぷれーと	たまむしプレート	固有名詞
がんせきぷれーと	がんせきプレート	固有名詞
もののけぷれーと	もののけプレート	固有名詞
りゅうのぷれーと	りゅうのプレート	固有名詞
こわもてぷれーと	こわもてプレート	固有名詞
こうてつぷれーと	こうてつプレート	固有名詞
あやしいおこう	あやしいおこう	固有名詞
がんせきおこう	がんせきおこう	固有名詞
まんぷくおこう	まんぷくおこう	固有名詞
さざなみのおこう	さざなみのおこう	固有名詞
おはなのおこう	おはなのおこう	固有名詞
こううんのおこう	こううんのおこう	固有名詞
きよめのおこう	きよめのおこう	固有名詞
ぷろてくたー	プロテクター	固有名詞
えれきぶーすたー	エレキブースター	固有名詞
まぐまぶーすたー	マグマブースター	固有名詞
あやしいぱっち	あやしいパッチ	固有名詞
れいかいのぬの	れいかいのぬの	固有名詞
するどいつめ	するどいツメ	固有名詞
するどいきば	するどいキバ	固有名詞
まんまるいし	まんまるいし	固有名詞
こんごうだま	こんごうだま	固有名詞
しらたま	しらたま	固有名詞
はっきんだま	はっきんだま	固有名詞
こうかくれんず	こうかくレンズ	固有名詞
ちからのはちまき	ちからのハチマキ	固有名詞
きあいのたすき	きあいのタスキ	固有名詞
ものしりめがね	ものしりメガネ	固有名詞
たつじんのおび	たつじんのおび	固有名詞
ひかりのねんど	ひかりのねんど	固有名詞
いのちのたま	いのちのたま	固有名詞
ぱわふるはーぶ	パワフルハーブ	固有名詞
どくどくだま	どくどくだま	固有名詞
かえんだま	かえんだま	固有名詞
すぴーどぱうだー	スピードパウダー	固有名詞
ふぉーかすれんず	フォーカスレンズ	固有名詞
めとろのーむ	メトロノーム	固有名詞
くろいてっきゅう	くろいてっきゅう	固有名詞
こうこうのしっぽ	こうこうのしっぽ	固有名詞
あかいいと	あかいいと	固有名詞
くろいへどろ	くろいヘドロ	固有名詞
つめたいいわ	つめたいいわ	固有名詞
さらさらいわ	さらさらいわ	固有名詞
あついいわ	あついいわ	固有名詞
しめったいわ	しめったいわ	固有名詞
ねばりのかぎづめ	ねばりのかぎづめ	固有名詞
こだわりすかーふ	こだわりスカーフ	固有名詞
くっつきばり	くっつきバリ	固有名詞
ぱわーりすと	パワーリスト	固有名詞
ぱわーべると	パワーベルト	固有名詞
ぱわーれんず	パワーレンズ	固有名詞
ぱわーばんど	パワーバンド	固有名詞
ぱわーあんくる	パワーアンクル	固有名詞
ぱわーうえいと	パワーウエイト	固有名詞
きれいなぬけがら	きれいなぬけがら	固有名詞
おおきなねっこ	おおきなねっこ	固有名詞
こだわりめがね	こだわりメガネ	固有名詞
あくあかせっと	アクアカセット	固有名詞
いなずまかせっと	イナズマカセット	固有名詞
ぶれいずかせっと	ブレイズカセット	固有名詞
ふりーずかせっと	フリーズカセット	固有名詞
きれいなうろこ	きれいなウロコ	固有名詞
しんかのきせき	しんかのきせき	固有名詞
かるいし	かるいし	固有名詞
ごつごつめっと	ゴツゴツメット	固有名詞
ふうせん	ふうせん	固有名詞
れっどかーど	レッドカード	固有名詞
ねらいのまと	ねらいのまと	固有名詞
しめつけばんど	しめつけバンド	固有名詞
きゅうこん	きゅうこん	固有名詞
じゅうでんち	じゅうでんち	固有名詞
だっしゅつぼたん	だっしゅつボタン	固有名詞
ほのおのじゅえる	ほのおのジュエル	固有名詞
みずのじゅえる	みずのジュエル	固有名詞
でんきのじゅえる	でんきのジュエル	固有名詞
くさのじゅえる	くさのジュエル	固有名詞
こおりのじゅえる	こおりのジュエル	固有名詞
かくとうじゅえる	かくとうジュエル	固有名詞
どくのじゅえる	どくのジュエル	固有名詞
じめんのじゅえる	じめんのジュエル	固有名詞
ひこうのじゅえる	ひこうのジュエル	固有名詞
えすぱーじゅえる	エスパージュエル	固有名詞
むしのじゅえる	むしのジュエル	固有名詞
いわのじゅえる	いわのジュエル	固有名詞
ごーすとじゅえる	ゴーストジュエル	固有名詞
どらごんじゅえる	ドラゴンジュエル	固有名詞
あくのじゅえる	あくのジュエル	固有名詞
はがねのじゅえる	はがねのジュエル	固有名詞
のーまるじゅえる	ノーマルジュエル	固有名詞
じゃくてんほけん	じゃくてんほけん	固有名詞
とつげきちょっき	とつげきチョッキ	固有名詞
せいれいぷれーと	せいれいプレート	固有名詞
ほいっぷぽっぷ	ホイップポップ	固有名詞
においぶくろ	においぶくろ	固有名詞
ひかりごけ	ひかりごけ	固有名詞
ゆきだま	ゆきだま	固有名詞
ぼうじんごーぐる	ぼうじんゴーグル	固有名詞
げんがないと	ゲンガナイト	固有名詞
さーないとないと	サーナイトナイト	固有名詞
でんりゅうないと	デンリュウナイト	固有名詞
ふしぎばないと	フシギバナイト	固有名詞
りざーどないとエックス	リザードナイトX	固有名詞
りざーどないとわい	リザードナイトY	固有名詞
かめっくすないと	カメックスナイト	固有名詞
みゅうつないとえっくす	ミュウツナイトX	固有名詞
みゅうつないとわい	ミュウツナイトY	固有名詞
ばしゃーもないと	バシャーモナイト	固有名詞
ちゃーれむないと	チャーレムナイト	固有名詞
へるがないと	ヘルガナイト	固有名詞
ぼすごどらないと	ボスゴドラナイト	固有名詞
じゅぺったないと	ジュペッタナイト	固有名詞
ばんぎらすないと	バンギラスナイト	固有名詞
はっさむないと	ハッサムナイト	固有名詞
かいろすないと	カイロスナイト	固有名詞
ぷてらないと	プテラナイト	固有名詞
るかりおないと	ルカリオナイト	固有名詞
ゆきのおないと	ユキノオナイト	固有名詞
がるーらないと	ガルーラナイト	固有名詞
ぎゃらどすないと	ギャラドスナイト	固有名詞
あぶそるないと	アブソルナイト	固有名詞
ふーでぃないと	フーディナイト	固有名詞
へらくろすないと	ヘラクロスナイト	固有名詞
くちーとないと	クチートナイト	固有名詞
らいぼるとないと	ライボルトナイト	固有名詞
がぶりあすないと	ガブリアスナイト	固有名詞
らてぃあすないと	ラティアスナイト	固有名詞
らてぃおすないと	ラティオスナイト	固有名詞
らぐらーじないと	ラグラージナイト	固有名詞
じゅかいんないと	ジュカインナイト	固有名詞
やみらみないと	ヤミラミナイト	固有名詞
ちるたりすないと	チルタリスナイト	固有名詞
えるれいどないと	エルレイドナイト	固有名詞
たぶんねないと	タブンネナイト	固有名詞
めたぐろすないと	メタグロスナイト	固有名詞
さめはだないと	サメハダナイト	固有名詞
やどらんないと	ヤドランナイト	固有名詞
はがねーるないと	ハガネールナイト	固有名詞
ぴじょっとないと	ピジョットナイト	固有名詞
おにごーりないと	オニゴーリナイト	固有名詞
でぃあんしないと	ディアンシナイト	固有名詞
ばくーだないと	バクーダナイト	固有名詞
みみろっぷないと	ミミロップナイト	固有名詞
ぼーまんだないと	ボーマンダナイト	固有名詞
すぴあないと	スピアナイト	固有名詞
のーまるぜっと	ノーマルZ	固有名詞
ほのおぜっと	ホノオZ	固有名詞
みずぜっと	ミズZ	固有名詞
でんきぜっと	デンキZ	固有名詞
くさぜっと	クサZ	固有名詞
こおりぜっと	コオリZ	固有名詞
かくとうぜっと	カクトウZ	固有名詞
どくぜっと	ドクZ	固有名詞
じめんぜっと	ジメンZ	固有名詞
ひこうぜっと	ヒコウZ	固有名詞
えすぱーぜっと	エスパーZ	固有名詞
むしぜっと	ムシZ	固有名詞
いわぜっと	イワZ	固有名詞
ごーすとぜっと	ゴーストZ	固有名詞
どらごんぜっと	ドラゴンZ	固有名詞
あくぜっと	アクZ	固有名詞
はがねぜっと	ハガネZ	固有名詞
ふぇありーぜっと	フェアリーZ	固有名詞
ぴかちゅうぜっと	ピカチュウZ	固有名詞
さとぴかぜっと	サトピカZ	固有名詞
あろらいぜっと	アロライZ	固有名詞
いーぶいぜっと	イーブイZ	固有名詞
かびごんぜっと	カビゴンZ	固有名詞
みゅうぜっと	ミュウZ	固有名詞
じゅないぱーぜっと	ジュナイパーZ	固有名詞
がおがえんぜっと	ガオガエンZ	固有名詞
あしれーぬぜっと	アシレーヌZ	固有名詞
かぷぜっと	カプZ	固有名詞
まーしゃどーぜっと	マーシャドーZ	固有名詞
そるがれおぜっと	ソルガレオZ	固有名詞
るなあーらぜっと	ルナアーラZ	固有名詞
うるとらねくろぜっと	ウルトラネクロZ	固有名詞
みみっきゅぜっと	ミミッキュZ	固有名詞
るがるがんぜっと	ルガルガンZ	固有名詞
じゃららんがぜっと	ジャラランガZ	固有名詞
ふぁいやーめもり	ファイヤーメモリ	固有名詞
うおーたーめもり	ウオーターメモリ	固有名詞
ぐらすめもり	グラスメモリ	固有名詞
えれくとろめもり	エレクトロメモリ	固有名詞
あいすめもり	アイスメモリ	固有名詞
ふぁいとめもり	ファイトメモリ	固有名詞
ぽいずんめもり	ポイズンメモリ	固有名詞
ぐらうんどめもり	グラウンドメモリ	固有名詞
ふらいんぐめもり	フライングメモリ	固有名詞
さいきっくめもり	サイキックメモリ	固有名詞
ばぐめもり	バグメモリ	固有名詞
ろっくめもり	ロックメモリ	固有名詞
ごーすとめもり	ゴーストメモリ	固有名詞
どらごんめもり	ドラゴンメモリ	固有名詞
だーくめもり	ダークメモリ	固有名詞
すちーるめもり	スチールメモリ	固有名詞
ふぇありーめもり	フェアリーメモリ	固有名詞
えれきしーど	エレキシード	固有名詞
ぐらすしーど	グラスシード	固有名詞
みすとしーど	ミストシード	固有名詞
さいこしーど	サイコシード	固有名詞
ぐらんどこーと	グランドコート	固有名詞
ぼうごぱっと	ぼうごパット	固有名詞
るーむさーびす	ルームサービス	固有名詞
だっしゅつぱっく	だっしゅつパック	固有名詞
あつぞこぶーつ	あつぞこブーツ	固有名詞
からぶりほけん	からぶりほけん	固有名詞
のどすぷれー	のどスプレー	固有名詞
ばんのうがさ	ばんのうがさ	固有名詞
くちたけん	くちたけん	固有名詞
くちたたて	くちたたて	固有名詞
いかさまだいす	いかさまダイス	固有名詞
おんみつまんと	おんみつマント	固有名詞
くりあちゃーむ	クリアチャーム	固有名詞
とくせいがーど	とくせいガード	固有名詞
ぱんちぐろーぶ	パンチグローブ	固有名詞
ぶーすとえなじー	ブーストエナジー	固有名詞
ものまねはーぶ	ものまねハーブ	固有名詞
だいこんごうだま	だいこんごうだま	固有名詞
だいしらたま	だいしらたま	固有名詞
だいはっきんだま	だいはっきんだま	固有名詞
ようせいのはね	ようせいのハネ	固有名詞
いどのめん	いどのめん	固有名詞
かまどのめん	かまどのめん	固有名詞
いしずえのめん	いしずえのめん	固有名詞
もんすたーぼーる	モンスターボール	固有名詞
すーぱーぼーる	スーパーボール	固有名詞
はいぱーぼーる	ハイパーボール	固有名詞
ますたーぼーる	マスターボール	固有名詞
さふぁりぼーる	サファリボール	固有名詞
へびーぼーる	ヘビーボール	固有名詞
れべるぼーる	レベルボール	固有名詞
るあーぼーる	ルアーボール	固有名詞
すぴーどぼーる	スピードボール	固有名詞
ふれんどぼーる	フレンドボール	固有名詞
むーんぼーる	ムーンボール	固有名詞
らぶらぶぼーる	ラブラブボール	固有名詞
こんぺぼーる	コンペボール	固有名詞
ねっとぼーる	ネットボール	固有名詞
だいぶぼーる	ダイブボール	固有名詞
ねすとぼーる	ネストボール	固有名詞
りぴーとぼーる	リピートボール	固有名詞
たいまーぼーる	タイマーボール	固有名詞
ごーじゃすぼーる	ゴージャスボール	固有名詞
ぷれみあぼーる	プレミアボール	固有名詞
ひーるぼーる	ヒールボール	固有名詞
だーくぼーる	ダークボール	固有名詞
くいっくぼーる	クイックボール	固有名詞
ぱーくぼーる	パークボール	固有名詞
ぷれしゃすぼーる	プレシャスボール	固有名詞
どりーむぼーる	ドリームボール	固有名詞
うるとらぼーる	ウルトラボール	固有名詞
めがとんぼーる	メガトンボール	固有名詞
ぎがとんぼーる	ギガトンボール	固有名詞
ふぇざーぼーる	フェザーボール	固有名詞
ういんぐぼーる	ウイングボール	固有名詞
じぇっとぼーる	ジェットボール	固有名詞
たいようのいし	たいようのいし	固有名詞
つきのいし	つきのいし	固有名詞
ほのおのいし	ほのおのいし	固有名詞
かみなりのいし	かみなりのいし	固有名詞
みずのいし	みずのいし	固有名詞
りーふのいし	リーフのいし	固有名詞
ひかりのいし	ひかりのいし	固有名詞
やみのいし	やみのいし	固有名詞
めざめいし	めざめいし	固有名詞
こおりのいし	こおりのいし	固有名詞
すっぱいりんご	すっぱいりんご	固有名詞
あまーいりんご	あまーいりんご	固有名詞
われたぽっと	われたポット	固有名詞
かけたぽっと	かけたポット	固有名詞
がらなつぶれす	ガラナツブレス	固有名詞
がらなつりーす	ガラナツリース	固有名詞
いちごあめざいく	いちごアメざいく	固有名詞
はーとあめざいく	ハートアメざいく	固有名詞
べりーあめざいく	ベリーアメざいく	固有名詞
よつばあめざいく	よつばアメざいく	固有名詞
おはなあめざいく	おはなアメざいく	固有名詞
すたーあめざいく	スターアメざいく	固有名詞
りぼんあめざいく	リボンアメざいく	固有名詞
つながりのひも	つながりのヒモ	固有名詞
くろのきせき	くろのきせき	固有名詞
ぴーとぶろっく	ピートブロック	固有名詞
いわいのよろい	イワイノヨロイ	固有名詞
のろいのよろい	ノロイノヨロイ	固有名詞
みついりりんご	みついりりんご	固有名詞
ぼんさくのちゃわん	ボンサクのちゃわん	固有名詞
けっさくのちゃわん	ケッサクのちゃわん	固有名詞
ふくごうきんぞく	ふくごうきんぞく	固有名詞
ちいさなきのこ	ちいさなキノコ	固有名詞
おおきなきのこ	おおきなキノコ	固有名詞
しんじゅ	しんじゅ	固有名詞
おおきなしんじゅ	おおきなしんじゅ	固有名詞
ほしのすな	ほしのすな	固有名詞
ほしのかけら	ほしのかけら	固有名詞
きんのはっぱ	きんのはっぱ	固有名詞
ぎんのはっぱ	ぎんのはっぱ	固有名詞
かわらのかけら	かわらのかけら	固有名詞
きんのたま	きんのたま	固有名詞
きちょうなほね	きちょうなホネ	固有名詞
きれいなはね	きれいなハネ	固有名詞
かおるきのこ	かおるキノコ	固有名詞
でかいきんのたま	でかいきんのたま	固有名詞
おだんごしんじゅ	おだんごしんじゅ	固有名詞
すいせいのかけら	すいせいのかけら	固有名詞
こだいのどうか	こだいのどうか	固有名詞
こだいのぎんか	こだいのぎんか	固有名詞
こだいのきんか	こだいのきんか	固有名詞
こだいのつぼ	こだいのツボ	固有名詞
こだいのうでわ	こだいのうでわ	固有名詞
こだいのせきぞう	こだいのせきぞう	固有名詞
こだいのおうかん	こだいのおうかん	固有名詞
ぽけもんこけし	ポケモンこけし	固有名詞
ちいさなたけのこ	ちいさなタケノコ	固有名詞
おおきなたけのこ	おおきなタケノコ	固有名詞
はながらめーる	はながらメール	固有名詞
なみのりめーる	なみのりメール	固有名詞
みずいろめーる	みずいろメール	固有名詞
にがおえめーる	にがおえメール	固有名詞
らぶりーめーる	ラブリーメール	固有名詞
ぶいぶいめーる	ブイブイメール	固有名詞
へんしんめーる	へんしんメール	固有名詞
あおぞらめーる	あおぞらメール	固有名詞
おんぷめーる	おんぷメール	固有名詞
まぼろしめーる	まぼろしメール	固有名詞
おれんじめーる	オレンジメール	固有名詞
はーばーめーる	ハーバーメール	固有名詞
きらきらめーる	キラキラメール	固有名詞
めかにかるめーる	メカニカルメール	固有名詞
うっでぃめーる	ウッディメール	固有名詞
くろすめーる	クロスメール	固有名詞
とれじゃーめーる	トレジャーメール	固有名詞
しゃどーめーる	シャドーメール	固有名詞
とろぴかるめーる	トロピカルメール	固有名詞
どりーむめーる	ドリームメール	固有名詞
みらくるめーる	ミラクルメール	固有名詞
れとろめーる	レトロメール	固有名詞
ぐらすめーる	グラスメール	固有名詞
ふれいむめーる	フレイムメール	固有名詞
ぶるーめーる	ブルーメール	固有名詞
ぶるーむめーる	ブルームメール	固有名詞
とんねるめーる	トンネルメール	固有名詞
すちーるめーる	スチールメール	固有名詞
らぶらぶめーる	ラブラブメール	固有名詞
ぶりざーどめーる	ブリザードメール	固有名詞
すぺーすめーる	スペースメール	固有名詞
えあめーる	エアメール	固有名詞
もざいくめーる	モザイクメール	固有名詞
ぶりっくめーる	ブリックメール	固有名詞
はじめてめーる	はじめてメール	固有名詞
だいすきめーる	だいすきメール	固有名詞
おさそいめーる	おさそいメール	固有名詞
かんしゃめーる	かんしゃメール	固有名詞
しつもんめーる	しつもんメール	固有名詞
おすすめめーる	おすすめメール	固有名詞
おかえしめーる	おかえしメール	固有名詞
ぶりっじめーるえす	ブリッジメールS	固有名詞
ぶりっじめーるえいち	ブリッジメールH	固有名詞
ぶりっじめーるしー	ブリッジメールC	固有名詞
ぶりっじめーるぶい	ブリッジメールV	固有名詞
ぶりっじめーるだぶりゅー	ブリッジメールW	固有名詞
えふぇくとがーど	エフェクトガード	固有名詞
くりてぃかっと	クリティカット	固有名詞
ぷらすぱわー	プラスパワー	固有名詞
でぃふぇんだー	ディフェンダー	固有名詞
すぴーだー	スピーダー	固有名詞
よくあたーる	ヨクアタール	固有名詞
すぺしゃるあっぷ	スペシャルアップ	固有名詞
すぺしゃるがーど	スペシャルガード	固有名詞
ぴっぴにんぎょう	ピッピにんぎょう	固有名詞
えねこのしっぽ	エネコのシッポ	固有名詞
あおいびーどろ	あおいビードロ	固有名詞
きいろびーどろ	きいろビードロ	固有名詞
あかいびーどろ	あかいビードロ	固有名詞
ぽけじゃらし	ポケじゃらし	固有名詞
すきるこーる	スキルコール	固有名詞
あいてむどろっぷ	アイテムドロップ	固有名詞
あいてむこーる	アイテムコール	固有名詞
ふらっとこーる	フラットコール	固有名詞
びびりだま	ビビリだま	固有名詞
おうえんぽん	おうえんポン	固有名詞
つかまえぽん	つかまえポン	固有名詞
だいきのこ	ダイキノコ	固有名詞
きずぐすり	キズぐすり	固有名詞
どくけし	どくけし	固有名詞
やけどなおし	やけどなおし	固有名詞
こおりなおし	こおりなおし	固有名詞
ねむけざまし	ねむけざまし	固有名詞
まひなおし	まひなおし	固有名詞
かいふくのくすり	かいふくのくすり	固有名詞
まんたんのくすり	まんたんのくすり	固有名詞
すごいきずぐすり	すごいキズぐすり	固有名詞
いいきずぐすり	いいキズぐすり	固有名詞
なんでもなおし	なんでもなおし	固有名詞
げんきのかけら	げんきのかけら	固有名詞
げんきのかたまり	げんきのかたまり	固有名詞
おいしいみず	おいしいみず	固有名詞
さいこそーだ	サイコソーダ	固有名詞
みっくすおれ	ミックスオレ	固有名詞
ぴーぴーえいど	ピーピーエイド	固有名詞
ぴーぴーりかばー	ピーピーリカバー	固有名詞
ぴーぴーえいだー	ピーピーエイダー	固有名詞
ぴーぴーまっくす	ピーピーマックス	固有名詞
もーもーみるく	モーモーミルク	固有名詞
ちからのこな	ちからのこな	固有名詞
ちからのねっこ	ちからのねっこ	固有名詞
ばんのうごな	ばんのうごな	固有名詞
ふっかつそう	ふっかつそう	固有名詞
せいなるはい	せいなるはい	固有名詞
いかりまんじゅう	いかりまんじゅう	固有名詞
ふえんせんべい	フエンせんべい	固有名詞
きのみじゅーす	きのみジュース	固有名詞
ふしぎなあめ	ふしぎなアメ	固有名詞
ぽいんとあっぷ	ポイントアップ	固有名詞
ぽいんとまっくす	ポイントマックス	固有名詞
もりのようかん	もりのヨウカン	固有名詞
はーとすいーつ	ハートスイーツ	固有名詞
ひうんあいす	ヒウンアイス	固有名詞
みあれがれっと	ミアレガレット	固有名詞
しゃらさぶれ	シャラサブレ	固有名詞
おおきいまらさだ	おおきいマラサダ	固有名詞
えいちぴーかいふくぽん	HPかいふくポン	固有名詞
ぴーぴーかいふくぽん	PPかいふくポン	固有名詞
にびあられ	ニビあられ	固有名詞
だいみつ	ダイミツ	固有名詞
ことぶきまふぃん	コトブキマフィン	固有名詞
かんぽーやく	カンポーやく	固有名詞
いいかんぽーやく	いいカンポーやく	固有名詞
すごいかんぽーやく	すごいカンポーやく	固有名詞
あらびきヴるすと	あらびきヴルスト	固有名詞
ぼぶのかんづめ	ボブのかんづめ	固有名詞
ばっくのかんづめ	バックのかんづめ	固有名詞
まめかん	マメかん	固有名詞
しょくぱん	しょくパン	固有名詞
ぱすた	パスタ	固有名詞
きのこぱっく	キノコパック	固有名詞
しっぽのくんせい	しっぽのくんせい	固有名詞
ふといながねぎ	ふといながねぎ	固有名詞
とくせんりんご	とくせんリンゴ	固有名詞
かぼそいほね	かぼそいホネ	固有名詞
ぽてとぱっく	ポテトパック	固有名詞
みずべのはーぶ	みずべのハーブ	固有名詞
やさいぱっく	やさいパック	固有名詞
ふらいもりあわせ	フライもりあわせ	固有名詞
ゆでたまご	ゆでタマゴ	固有名詞
ふさぱっく	フサパック	固有名詞
もーもーちーず	モーモーチーズ	固有名詞
すぱいすせっと	スパイスセット	固有名詞
しんせんくりーむ	しんせんクリーム	固有名詞
れとるとかれー	レトルトカレー	固有名詞
やしのみるく	ヤシのミルク	固有名詞
れとるとめん	レトルトめん	固有名詞
れとるとばーぐ	レトルトバーグ	固有名詞
きょだいぱうだー	キョダイパウダー	固有名詞
まよねーず	マヨネーズ	固有名詞
けちゃっぷ	ケチャップ	固有名詞
ますたーど	マスタード	固有名詞
ばたー	バター	固有名詞
ぴーなっつばたー	ピーナッツバター	固有名詞
ちりそーす	チリソース	固有名詞
そると	ソルト	固有名詞
ぺっぱー	ペッパー	固有名詞
よーぐると	ヨーグルト	固有名詞
ほいっぷくりーむ	ホイップクリーム	固有名詞
くりーむちーず	クリームチーズ	固有名詞
べりーじゃむ	ベリージャム	固有名詞
まーまれーど	マーマレード	固有名詞
おりーぶおいる	オリーブオイル	固有名詞
びねがー	ビネガー	固有名詞
ひでん:あますぱいす	ひでん:あまスパイス	固有名詞
ひでん:しおすぱいす	ひでん:しおスパイス	固有名詞
ひでん:すぱすぱいす	ひでん:すぱスパイス	固有名詞
ひでん:にがすぱいす	ひでん:にがスパイス	固有名詞
ひでん:からすぱいす	ひでん:からスパイス	固有名詞
ほーすらでぃっしゅ	ホースラディッシュ	固有名詞
かれーぱうだー	カレーパウダー	固有名詞
わさびそーす	ワサビソース	固有名詞
れたす	レタス	固有名詞
とまとすらいす	トマトスライス	固有名詞
かっとみにとまと	カットミニトマト	固有名詞
きゅうりすらいす	キュウリスライス	固有名詞
ぴくるすすらいす	ピクルススライス	固有名詞
たまねぎすらいす	たまねぎスライス	固有名詞
あーりーれっど	アーリーレッド	固有名詞
ぴーまんすらいす	ピーマンスライス	固有名詞
あかぱぷりかすらいす	あかパプリカスライス	固有名詞
きぱぷりかすらいす	きパプリカスライス	固有名詞
あぼかど	アボカド	固有名詞
やきべーこん	やきベーコン	固有名詞
はむすらいす	ハムスライス	固有名詞
なまはむ	なまハム	固有名詞
やきちょりそー	やきチョリソー	固有名詞
はーぶそーせーじ	ハーブソーセージ	固有名詞
はんばーぐ	ハンバーグ	固有名詞
がけがにすてぃっく	ガケガニスティック	固有名詞
すもーくきりみ	スモークきりみ	固有名詞
きりみふらい	きりみフライ	固有名詞
すらいすえっぐ	スライスエッグ	固有名詞
とるてぃーじゃ	トルティージャ	固有名詞
とーふ	トーフ	固有名詞
らいす	ライス	固有名詞
ぬーどる	ヌードル	固有名詞
ぽてとさらだ	ポテトサラダ	固有名詞
すらいすちーず	スライスチーズ	固有名詞
ばななすらいす	バナナスライス	固有名詞
いちごすらいす	いちごスライス	固有名詞
わぎりりんご	わぎりリンゴ	固有名詞
わぎりきうい	わぎりキウイ	固有名詞
かっとぱいん	カットパイン	固有名詞
はらぺーにょ	ハラペーニョ	固有名詞
くれそん	クレソン	固有名詞
ばじる	バジル	固有名詞
ごーるどぴっく	ゴールドピック	固有名詞
しるばーぴっく	シルバーピック	固有名詞
あかいはたぴっく	あかいはたピック	固有名詞
あおいはたぴっく	あおいはたピック	固有名詞
ぴかぴかぴっく	ピカピカピック	固有名詞
ぱちぴかぴっく	パチピカピック	固有名詞
ぶいぶいぴっく	ブイブイピック	固有名詞
にこぶいぴっく	ニコブイピック	固有名詞
あおぼーるぴっく	あおボールピック	固有名詞
みどりぼーるぴっく	みどりボールピック	固有名詞
あかぼーるぴっく	あかボールピック	固有名詞
おいわいはなびぴっく	おいわいはなびピック	固有名詞
ゆうしゃのけんぴっく	ゆうしゃのけんピック	固有名詞
まじかるすたーぴっく	マジカルスターピック	固有名詞
まじかるはーとぴっく	マジカルハートピック	固有名詞
ぱらそるぴっく	パラソルピック	固有名詞
あおぞらおはなぴっく	あおぞらおはなピック	固有名詞
ゆうやけおはなぴっく	ゆうやけおはなピック	固有名詞
あさやけおはなぴっく	あさやけおはなピック	固有名詞
むしよけすぷれー	むしよけスプレー	固有名詞
しるばーすぷれー	シルバースプレー	固有名詞
ごーるどすぷれー	ゴールドスプレー	固有名詞
あなぬけのひも	あなぬけのヒモ	固有名詞
まっくすあっぷ	マックスアップ	固有名詞
たうりん	タウリン	固有名詞
ぶろむへきしん	ブロムヘキシン	固有名詞
りぞちうむ	リゾチウム	固有名詞
きとさん	キトサン	固有名詞
いんどめたしん	インドメタシン	固有名詞
たいりょくのはね	たいりょくのハネ	固有名詞
きんりょくのはね	きんりょくのハネ	固有名詞
ていこうのはね	ていこうのハネ	固有名詞
ちりょくのはね	ちりょくのハネ	固有名詞
せいしんのはね	せいしんのハネ	固有名詞
しゅんぱつのはね	しゅんぱつのハネ	固有名詞
くろいびーどろ	くろいビードロ	固有名詞
しろいびーどろ	しろいビードロ	固有名詞
あさせのしお	あさせのしお	固有名詞
あさせのかいがら	あさせのかいがら	固有名詞
はーとのうろこ	ハートのウロコ	固有名詞
あかいかけら	あかいかけら	固有名詞
あおいかけら	あおいかけら	固有名詞
きいろいかけら	きいろいかけら	固有名詞
みどりのかけら	みどりのかけら	固有名詞
がくしゅうそうち	がくしゅうそうち	固有名詞
きのはこ	きのはこ	固有名詞
きりのはこ	きりのはこ	固有名詞
おいしいしっぽ	おいしいシッポ	固有名詞
あまいみつ	あまいミツ	固有名詞
ときのふえ	ときのふえ	固有名詞
ぽけまんま	ポケまんま	固有名詞
すくすくこやし	すくすくこやし	固有名詞
じめじめこやし	じめじめこやし	固有名詞
ながながこやし	ながながこやし	固有名詞
ねばねばこやし	ねばねばこやし	固有名詞
ねっこのかせき	ねっこのカセキ	固有名詞
つめのかせき	ツメのカセキ	固有名詞
かいのかせき	かいのカセキ	固有名詞
こうらのかせき	こうらのカセキ	固有名詞
ひみつのこはく	ひみつのコハク	固有名詞
たてのかせき	たてのカセキ	固有名詞
ずがいのかせき	ずがいのカセキ	固有名詞
かなめいし	かなめいし	固有名詞
ふたのかせき	ふたのカセキ	固有名詞
はねのかせき	はねのカセキ	固有名詞
でるだま	デルダマ	固有名詞
とくせいかぷせる	とくせいカプセル	固有名詞
たわわこやし	たわわこやし	固有名詞
びっくりこやし	びっくりこやし	固有名詞
ぐんぐんこやし	ぐんぐんこやし	固有名詞
とんでもこやし	とんでもこやし	固有名詞
ばーげんちけっと	バーゲンチケット	固有名詞
ふしぎなおきもの	ふしぎなおきもの	固有名詞
あごのかせき	アゴのカセキ	固有名詞
ひれのかせき	ヒレのカセキ	固有名詞
やまぶきのみつ	やまぶきのミツ	固有名詞
うすもものみつ	うすもものミツ	固有名詞
くれないのみつ	くれないのミツ	固有名詞
むらさきのみつ	むらさきのミツ	固有名詞
ふぇすちけっと	フェスチケット	固有名詞
きんのおうかん	きんのおうかん	固有名詞
ぎんのおうかん	ぎんのおうかん	固有名詞
たまごふかぽん	タマゴふかポン	固有名詞
やすうりぽん	やすうりポン	固有名詞
おこづかいぽん	おこづかいポン	固有名詞
けいけんぽん	けいけんポン	固有名詞
なつきぽん	なつきポン	固有名詞
みっけぽん	みっけポン	固有名詞
かくれぽん	かくれポン	固有名詞
むしよせころん	むしよせコロン	固有名詞
しるばーころん	シルバーコロン	固有名詞
ごーるどころん	ゴールドコロン	固有名詞
ぎんのずりのみ	ぎんのズリのみ	固有名詞
きんのずりのみ	きんのズリのみ	固有名詞
ぎんのななのみ	ぎんのナナのみ	固有名詞
きんのななのみ	きんのナナのみ	固有名詞
ぎんのぱいるのみ	ぎんのパイルのみ	固有名詞
きんのぱいるのみ	きんのパイルのみ	固有名詞
うみべのがらす	うみべのガラス	固有名詞
かたっぽぴあす	かたっぽピアス	固有名詞
このはのおてがみ	このはのおてがみ	固有名詞
ちいさなはなたば	ちいさなはなたば	固有名詞
ちょーくいし	チョークいし	固有名詞
なんごくかいがら	なんごくかいがら	固有名詞
のびたばね	のびたバネ	固有名詞
びーだま	ビーだま	固有名詞
ぴかぴかだんご	ピカピカだんご	固有名詞
ねがいのかたまり	ねがいのかたまり	固有名詞
だいくりすたる	ダイクリスタル	固有名詞
だいまっくすあめ	ダイマックスアメ	固有名詞
けいけんあめえっくすえす	けいけんアメXS	固有名詞
けいけんあめえす	けいけんアメS	固有名詞
けいけんあめえむ	けいけんアメM	固有名詞
けいけんあめえる	けいけんアメL	固有名詞
けいけんあめえっくすえる	けいけんアメXL	固有名詞
さみしがりみんと	さみしがりミント	固有名詞
いじっぱりみんと	いじっぱりミント	固有名詞
やんちゃみんと	やんちゃミント	固有名詞
ゆうかんみんと	ゆうかんミント	固有名詞
ずぶといみんと	ずぶといミント	固有名詞
わんぱくみんと	わんぱくミント	固有名詞
のうてんきみんと	のうてんきミント	固有名詞
のんきみんと	のんきミント	固有名詞
ひかえめみんと	ひかえめミント	固有名詞
おっとりみんと	おっとりミント	固有名詞
うっかりやみんと	うっかりやミント	固有名詞
れいせいみんと	れいせいミント	固有名詞
おだやかみんと	おだやかミント	固有名詞
おとなしいみんと	おとなしいミント	固有名詞
しんちょうみんと	しんちょうミント	固有名詞
なまいきみんと	なまいきミント	固有名詞
おくびょうみんと	おくびょうミント	固有名詞
せっかちみんと	せっかちミント	固有名詞
ようきみんと	ようきミント	固有名詞
むじゃきみんと	むじゃきミント	固有名詞
まじめみんと	まじめミント	固有名詞
かせきのとり	カセキのトリ	固有名詞
かせきのさかな	カセキのサカナ	固有名詞
かせきのりゅう	カセキのリュウ	固有名詞
かせきのくびなが	カセキのクビナガ	固有名詞
がらなつのえだ	ガラナツのえだ	固有名詞
よろいこうせき	ヨロイこうせき	固有名詞
あかぼんぐり	あかぼんぐり	固有名詞
あおぼんぐり	あおぼんぐり	固有名詞
きぼんぐり	きぼんぐり	固有名詞
みどぼんぐり	みどぼんぐり	固有名詞
ももぼんぐり	ももぼんぐり	固有名詞
しろぼんぐり	しろぼんぐり	固有名詞
くろぼんぐり	くろぼんぐり	固有名詞
とくせいぱっち	とくせいパッチ	固有名詞
まっくすこうせき	マックスこうせき	固有名詞
なぞのかけらえす	なぞのかけらS	固有名詞
なぞのかけらえる	なぞのかけらL	固有名詞
みちびきのせきばん	みちびきのせきばん	固有名詞
じょうとのせきばん	ジョウトのせきばん	固有名詞
かんとーのせきばん	カントーのせきばん	固有名詞
こころのせきばん	こころのせきばん	固有名詞
にじのせきばん	にじのせきばん	固有名詞
あらしのせきばん	あらしのせきばん	固有名詞
たいかいのせきばん	たいかいのせきばん	固有名詞
たいりくのせきばん	たいりくのせきばん	固有名詞
てんくうのせきばん	てんくうのせきばん	固有名詞
いでんしのせきばん	いでんしのせきばん	固有名詞
やぶれたせきばん	やぶれたせきばん	固有名詞
せめのがんやく	せめのがんやく	固有名詞
まもりのがんやく	まもりのがんやく	固有名詞
よくあたらーぬ	ヨクアタラーヌ	固有名詞
まるちあっぷ	マルチアップ	固有名詞
こだわりちまき	こだわりちまき	固有名詞
にばいづけ	にばいづけ	固有名詞
あべこべやき	あべこべやき	固有名詞
ひそやかすぷれー	ひそやかスプレー	固有名詞
きのこよせだま	キノコよせだま	固有名詞
みつよせだま	ミツよせだま	固有名詞
いなほよせだま	イナホよせだま	固有名詞
まめよせだま	マメよせだま	固有名詞
みねらるよせだま	ミネラルよせだま	固有名詞
めかくしだま	めかくしだま	固有名詞
ばりばりだま	ばりばりだま	固有名詞
ねばりだま	ねばりだま	固有名詞
どろだんご	どろだんご	固有名詞
むしくいぼんぐり	むしくいぼんぐり	固有名詞
ゆきだま	ゆきだま	固有名詞
もちもちきのこ	もちもちキノコ	固有名詞
きらきらみつ	きらきらミツ	固有名詞
いきいきいなほ	いきいきイナホ	固有名詞
ころころまめ	ころころマメ	固有名詞
ごりごりみねらる	ごりごりミネラル	固有名詞
ぼんぐりのみ	ぼんぐりのみ	固有名詞
たまいし	たまいし	固有名詞
くろいろたまいし	くろいろたまいし	固有名詞
そらいろたまいし	そらいろたまいし	固有名詞
てつのかけら	てつのかけら	固有名詞
かげぶんしめじ	カゲブンシメジ	固有名詞
きゅうしょうろ	キュウショウロ	固有名詞
きんぐりーふ	キングリーフ	固有名詞
くすりそう	クスリソウ	固有名詞
けむりいも	ケムリイモ	固有名詞
げんきのつぼみ	ゲンキノツボミ	固有名詞
すいーととりゅふ	スイートトリュフ	固有名詞
すなはまだいこん	スナハマダイコン	固有名詞
たまぜんまい	タマゼンマイ	固有名詞
つるぎまいたけ	ツルギマイタケ	固有名詞
てっぺきくらげ	テッペキクラゲ	固有名詞
ばりばりも	バリバリモ	固有名詞
ぴーぴーぐさ	ピーピーグサ	固有名詞
むしよけそう	ムシヨケソウ	固有名詞
もくざい	もくざい	固有名詞
よせだまのもと	よせだまのもと	固有名詞
がんばりのすな	ガンバリのすな	固有名詞
がんばりのじゃり	ガンバリのじゃり	固有名詞
がんばりのいし	ガンバリのいし	固有名詞
がんばりのいわ	ガンバリのいわ	固有名詞
かいでんのたね	かいでんのタネ	固有名詞
みがわりおまもりいち	みがわりおまもり1	固有名詞
みがわりおまもりに	みがわりおまもり2	固有名詞
みがわりおまもりさん	みがわりおまもり3	固有名詞
みがわりおまもりよん	みがわりおまもり4	固有名詞
みがわりおまもりご	みがわりおまもり5	固有名詞
あんぜんおまもりいち	あんぜんおまもり1	固有名詞
あんぜんおまもりに	あんぜんおまもり2	固有名詞
あんぜんおまもりさん	あんぜんおまもり3	固有名詞
あんぜんおまもりよん	あんぜんおまもり4	固有名詞
あんぜんおまもりご	あんぜんおまもり5	固有名詞
けんこうおまもりいち	けんこうおまもり1	固有名詞
けんこうおまもりに	けんこうおまもり2	固有名詞
けんこうおまもりさん	けんこうおまもり3	固有名詞
けんこうおまもりよん	けんこうおまもり4	固有名詞
けんこうおまもりご	けんこうおまもり5	固有名詞
かしらのしるし	かしらのしるし	固有名詞
てらぴーすのーまる	テラピースノーマル	固有名詞
てらぴーすほのお	テラピースほのお	固有名詞
てらぴーすみず	テラピースみず	固有名詞
てらぴーすくさ	テラピースくさ	固有名詞
てらぴーすでんき	テラピースでんき	固有名詞
てらぴーすこおり	テラピースこおり	固有名詞
てらぴーすかくとう	テラピースかくとう	固有名詞
てらぴーすどく	テラピースどく	固有名詞
てらぴーすじめん	テラピースじめん	固有名詞
てらぴーすひこう	テラピースひこう	固有名詞
てらぴーすえすぱー	テラピースエスパー	固有名詞
てらぴーすむし	テラピースむし	固有名詞
てらぴーすいわ	テラピースいわ	固有名詞
てらぴーすごーすと	テラピースゴースト	固有名詞
てらぴーすどらごん	テラピースドラゴン	固有名詞
てらぴーすあく	テラピースあく	固有名詞
てらぴーすはがね	テラピースはがね	固有名詞
てらぴーすふぇありー	テラピースフェアリー	固有名詞
てらぴーすすてら	テラピースステラ	固有名詞
たいりょくのもち	たいりょくのもち	固有名詞
きんりょくのもち	きんりょくのもち	固有名詞
ていこうのもち	ていこうのもち	固有名詞
ちりょくのもち	ちりょくのもち	固有名詞
せいしんのもち	せいしんのもち	固有名詞
しゅんぱつのもち	しゅんぱつのもち	固有名詞
まっさらもち	まっさらもち	固有名詞
