ひかりのこな	Bright Powder	固有名詞	
せんせいのつめ	Quick Claw	固有名詞	
おうじゃのしるし	King's Rock	固有名詞	
ぎんのこな	Silver Powder	固有名詞	
おまもりこばん	Amulet Coin	固有名詞	
きよめのおふだ	Cleanse Tag	固有名詞	
けむりだま	Smoke Ball	固有名詞	
かわらずのいし	Everstone	固有名詞	
きあいのはちまき	Focus Band	固有名詞	
しあわせたまご	Lucky Egg	固有名詞	
ぴんとれんず	Scope Lens	固有名詞	
めたるこーと	Metal Coat	固有名詞	
たべのこし	Leftovers	固有名詞	
りゅうのうろこ	Dragon Scale	固有名詞	
でんきだま	Light Ball	固有名詞	
やわらかいすな	Soft Sand	固有名詞	
かたいいし	Hard Stone	固有名詞	
きせきのたね	Miracle Seed	固有名詞	
くろいめがね	Black Glasses	固有名詞	
くろおび	Black Belt	固有名詞	
じしゃく	Magnet	固有名詞	
しんぴのしずく	Mystic Water	固有名詞	
するどいくちばし	Sharp Beak	固有名詞	
どくばり	Poison Barb	固有名詞	
とけないこおり	Never-Melt Ice	固有名詞	
のろいのおふだ	Spell Tag	固有名詞	
まがったすぷーん	Twisted Spoon	固有名詞	
もくたん	Charcoal	固有名詞	
りゅうのきば	Dragon Fang	固有名詞	
ぴんくのりぼん	Pink Bow	固有名詞	
みずたまりぼん	Polkadot Bow	固有名詞	
あっぷぐれーど	Up-Grade	固有名詞	
らっきーぱんち	Lucky Punch	固有名詞	
めたるぱうだー	Metal Powder	固有名詞	
ふといほね	Thick Club	固有名詞	
ながねぎ	Stick2-7Leek8	固有名詞	
はかいのいでんし	Berserk Gene	固有名詞	
しろいはーぶ	White Herb	固有名詞	
きょうせいぎぷす	Macho Brace	固有名詞	
やすらぎのすず	Soothe Bell	固有名詞	
めんたるはーぶ	Mental Herb	固有名詞	
こだわりはちまき	Choice Band	固有名詞	
こころのしずく	Soul Dew	固有名詞	
しんかいのきば	Deep Sea Tooth	固有名詞	
しんかいのうろこ	Deep Sea Scale	固有名詞	
しるくのすかーふ	Silk Scarf	固有名詞	
かいがらのすず	Shell Bell	固有名詞	
うしおのおこう	Sea Incense	固有名詞	
のんきのおこう	Lax Incense	固有名詞	
あかいばんだな	Red Scarf	固有名詞	
あおいばんだな	Blue Scarf	固有名詞	
ぴんくのばんだな	Pink Scarf	固有名詞	
みどりのばんだな	Green Scarf	固有名詞	
きいろのばんだな	Yellow Scarf	固有名詞	
べにいろのたま	Red Orb	固有名詞	
あいいろのたま	Blue Orb	固有名詞	
ひのたまぷれーと	Flame Plate	固有名詞	
しずくぷれーと	Splash Plate	固有名詞	
いかずちぷれーと	Zap Plate	固有名詞	
みどりのぷれーと	Meadow Plate	固有名詞	
つららのぷれーと	Icicle Plate	固有名詞	
こぶしのぷれーと	Fist Plate	固有名詞	
もうどくぷれーと	Toxic Plate	固有名詞	
だいちのぷれーと	Earth Plate	固有名詞	
あおぞらぷれーと	Sky Plate	固有名詞	
ふしぎのぷれーと	Mind Plate	固有名詞	
たまむしぷれーと	Insect Plate	固有名詞	
がんせきぷれーと	Stone Plate	固有名詞	
もののけぷれーと	Spooky Plate	固有名詞	
りゅうのぷれーと	Draco Plate	固有名詞	
こわもてぷれーと	Dread Plate	固有名詞	
こうてつぷれーと	Iron Plate	固有名詞	
あやしいおこう	Odd Incense	固有名詞	
がんせきおこう	Rock Incense	固有名詞	
まんぷくおこう	Full Incense	固有名詞	
さざなみのおこう	Wave Incense	固有名詞	
おはなのおこう	Rose Incense	固有名詞	
こううんのおこう	Luck Incense	固有名詞	
きよめのおこう	Pure Incense	固有名詞	
ぷろてくたー	Protector	固有名詞	
えれきぶーすたー	Electirizer	固有名詞	
まぐまぶーすたー	Magmarizer	固有名詞	
あやしいぱっち	Dubious Disc	固有名詞	
れいかいのぬの	Reaper Cloth	固有名詞	
するどいつめ	Razor Claw	固有名詞	
するどいきば	Razor Fang	固有名詞	
まんまるいし	Oval Stone	固有名詞	
こんごうだま	Adamant Orb	固有名詞	
しらたま	Lustrous Orb	固有名詞	
はっきんだま	Griseous Orb	固有名詞	
こうかくれんず	Wide Lens	固有名詞	
ちからのはちまき	Muscle Band	固有名詞	
きあいのたすき	Focus Sash	固有名詞	
ものしりめがね	Wise Glasses	固有名詞	
たつじんのおび	Expert Belt	固有名詞	
ひかりのねんど	Light Clay	固有名詞	
いのちのたま	Life Orb	固有名詞	
ぱわふるはーぶ	Power Herb	固有名詞	
どくどくだま	Toxic Orb	固有名詞	
かえんだま	Flame Orb	固有名詞	
すぴーどぱうだー	Quick Powder	固有名詞	
ふぉーかすれんず	Zoom Lens	固有名詞	
めとろのーむ	Metronome	固有名詞	
くろいてっきゅう	Iron Ball	固有名詞	
こうこうのしっぽ	Lagging Tail	固有名詞	
あかいいと	Destiny Knot	固有名詞	
くろいへどろ	Black Sludge	固有名詞	
つめたいいわ	Icy Rock	固有名詞	
さらさらいわ	Smooth Rock	固有名詞	
あついいわ	Heat Rock	固有名詞	
しめったいわ	Damp Rock	固有名詞	
ねばりのかぎづめ	Grip Claw	固有名詞	
こだわりすかーふ	Choice Scarf	固有名詞	
くっつきばり	Sticky Barb	固有名詞	
ぱわーりすと	Power Bracer	固有名詞	
ぱわーべると	Power Belt	固有名詞	
ぱわーれんず	Power Lens	固有名詞	
ぱわーばんど	Power Band	固有名詞	
ぱわーあんくる	Power Anklet	固有名詞	
ぱわーうえいと	Power Weight	固有名詞	
きれいなぬけがら	Shed Shell	固有名詞	
おおきなねっこ	Big Root	固有名詞	
こだわりめがね	Choice Specs	固有名詞	
あくあかせっと	Douse Drive	固有名詞	
いなずまかせっと	Shock Drive	固有名詞	
ぶれいずかせっと	Burn Drive	固有名詞	
ふりーずかせっと	Chill Drive	固有名詞	
きれいなうろこ	Prism Scale	固有名詞	
しんかのきせき	Eviolite	固有名詞	
かるいし	Float Stone	固有名詞	
ごつごつめっと	Rocky Helmet	固有名詞	
ふうせん	Air Balloon	固有名詞	
れっどかーど	Red Card	固有名詞	
ねらいのまと	Ring Target	固有名詞	
しめつけばんど	Binding Band	固有名詞	
きゅうこん	Absorb Bulb	固有名詞	
じゅうでんち	Cell Battery	固有名詞	
だっしゅつぼたん	Eject Button	固有名詞	
ほのおのじゅえる	Fire Gem	固有名詞	
みずのじゅえる	Water Gem	固有名詞	
でんきのじゅえる	Electric Gem	固有名詞	
くさのじゅえる	Grass Gem	固有名詞	
こおりのじゅえる	Ice Gem	固有名詞	
かくとうじゅえる	Fighting Gem	固有名詞	
どくのじゅえる	Poison Gem	固有名詞	
じめんのじゅえる	Ground Gem	固有名詞	
ひこうのじゅえる	Flying Gem	固有名詞	
えすぱーじゅえる	Psychic Gem	固有名詞	
むしのじゅえる	Bug Gem	固有名詞	
いわのじゅえる	Rock Gem	固有名詞	
ごーすとじゅえる	Ghost Gem	固有名詞	
どらごんじゅえる	Dragon Gem	固有名詞	
あくのじゅえる	Dark Gem	固有名詞	
はがねのじゅえる	Steel Gem	固有名詞	
のーまるじゅえる	Normal Gem	固有名詞	
じゃくてんほけん	Weakness Policy	固有名詞	
とつげきちょっき	Assault Vest	固有名詞	
せいれいぷれーと	Pixie Plate	固有名詞	
ほいっぷぽっぷ	Whipped Dream	固有名詞	
においぶくろ	Sachet	固有名詞	
ひかりごけ	Luminous Moss	固有名詞	
ゆきだま	Snowball	固有名詞	
ぼうじんごーぐる	Safety Goggles	固有名詞	
げんがないと	Gengarite	固有名詞	
さーないとないと	Gardevoirite	固有名詞	
でんりゅうないと	Ampharosite	固有名詞	
ふしぎばないと	Venusaurite	固有名詞	
りざーどないとえっくす	Charizardite X	固有名詞	
りざーどないとわい	Charizardite Y	固有名詞	
かめっくすないと	Blastoisinite	固有名詞	
みゅうつないとえっくす	Mewtwonite X	固有名詞	
みゅうつないとわい	Mewtwonite Y	固有名詞	
ばしゃーもないと	Blazikenite	固有名詞	
ちゃーれむないと	Medichamite	固有名詞	
へるがないと	Houndoominite	固有名詞	
ぼすごどらないと	Aggronite	固有名詞	
じゅぺったないと	Banettite	固有名詞	
ばんぎらすないと	Tyranitarite	固有名詞	
はっさむないと	Scizorite	固有名詞	
かいろすないと	Pinsirite	固有名詞	
ぷてらないと	Aerodactylite	固有名詞	
るかりおないと	Lucarionite	固有名詞	
ゆきのおないと	Abomasite	固有名詞	
がるーらないと	Kangaskhanite	固有名詞	
ぎゃらどすないと	Gyaradosite	固有名詞	
あぶそるないと	Absolite	固有名詞	
ふーでぃないと	Alakazite	固有名詞	
へらくろすないと	Heracronite	固有名詞	
くちーとないと	Mawilite	固有名詞	
らいぼるとないと	Manectite	固有名詞	
がぶりあすないと	Garchompite	固有名詞	
らてぃあすないと	Latiasite	固有名詞	
らてぃおすないと	Latiosite	固有名詞	
らぐらーじないと	Swampertite	固有名詞	
じゅかいんないと	Sceptilite	固有名詞	
やみらみないと	Sablenite	固有名詞	
ちるたりすないと	Altarianite	固有名詞	
えるれいどないと	Galladite	固有名詞	
たぶんねないと	Audinite	固有名詞	
めたぐろすないと	Metagrossite	固有名詞	
さめはだないと	Sharpedonite	固有名詞	
やどらんないと	Slowbronite	固有名詞	
はがねーるないと	Steelixite	固有名詞	
ぴじょっとないと	Pidgeotite	固有名詞	
おにごーりないと	Glalitite	固有名詞	
でぃあんしないと	Diancite	固有名詞	
ばくーだないと	Cameruptite	固有名詞	
みみろっぷないと	Lopunnite	固有名詞	
ぼーまんだないと	Salamencite	固有名詞	
すぴあないと	Beedrillite	固有名詞	
のーまるぜっと	Normalium Z	固有名詞	
ほのおぜっと	Firium Z	固有名詞	
みずぜっと	Waterium Z	固有名詞	
でんきぜっと	Electrium Z	固有名詞	
くさぜっと	Grassium Z	固有名詞	
こおりぜっと	Icium Z	固有名詞	
かくとうぜっと	Fightinium Z	固有名詞	
どくぜっと	Poisonium Z	固有名詞	
じめんぜっと	Groundium Z	固有名詞	
ひこうぜっと	Flyinium Z	固有名詞	
えすぱーぜっと	Psychium Z	固有名詞	
むしぜっと	Buginium Z	固有名詞	
いわぜっと	Rockium Z	固有名詞	
ごーすとぜっと	Ghostium Z	固有名詞	
どらごんぜっと	Dragonium Z	固有名詞	
あくぜっと	Darkinium Z	固有名詞	
はがねぜっと	Steelium Z	固有名詞	
ふぇありーぜっと	Fairium Z	固有名詞	
ぴかちゅうぜっと	Pikanium Z	固有名詞	
さとぴかぜっと	Pikashunium Z	固有名詞	
あろらいぜっと	Aloraichium Z	固有名詞	
いーぶいぜっと	Eevium Z	固有名詞	
かびごんぜっと	Snorlium Z	固有名詞	
みゅうぜっと	Mewnium Z	固有名詞	
じゅないぱーぜっと	Decidium Z	固有名詞	
がおがえんぜっと	Incinium Z	固有名詞	
あしれーぬぜっと	Primarium Z	固有名詞	
かぷぜっと	Tapunium Z	固有名詞	
まーしゃどーぜっと	Marshadium Z	固有名詞	
そるがれおぜっと	Solganium Z	固有名詞	
るなあーらぜっと	Lunalium Z	固有名詞	
うるとらねくろぜっと	Ultranecrozium Z	固有名詞	
みみっきゅぜっと	Mimikium Z	固有名詞	
るがるがんぜっと	Lycanium Z	固有名詞	
じゃららんがぜっと	Kommonium Z	固有名詞	
ふぁいやーめもり	Fire Memory	固有名詞	
うおーたーめもり	Water Memory	固有名詞	
ぐらすめもり	Grass Memory	固有名詞	
えれくとろめもり	Electric Memory	固有名詞	
あいすめもり	Ice Memory	固有名詞	
ふぁいとめもり	Fighting Memory	固有名詞	
ぽいずんめもり	Poison Memory	固有名詞	
ぐらうんどめもり	Ground Memory	固有名詞	
ふらいんぐめもり	Flying Memory	固有名詞	
さいきっくめもり	Psychic Memory	固有名詞	
ばぐめもり	Bug Memory	固有名詞	
ろっくめもり	Rock Memory	固有名詞	
ごーすとめもり	Ghost Memory	固有名詞	
どらごんめもり	Dragon Memory	固有名詞	
だーくめもり	Dark Memory	固有名詞	
すちーるめもり	Steel Memory	固有名詞	
ふぇありーめもり	Fairy Memory	固有名詞	
えれきしーど	Electric Seed	固有名詞	
ぐらすしーど	Grassy Seed	固有名詞	
みすとしーど	Misty Seed	固有名詞	
さいこしーど	Psychic Seed	固有名詞	
ぐらんどこーと	Terrain Extender	固有名詞	
ぼうごぱっと	Protective Pads	固有名詞	
るーむさーびす	Room Service	固有名詞	
だっしゅつぱっく	Eject Pack	固有名詞	
あつぞこぶーつ	Heavy-Duty Boots	固有名詞	
からぶりほけん	Blunder Policy	固有名詞	
のどすぷれー	Throat Spray	固有名詞	
ばんのうがさ	Utility Umbrella	固有名詞	
くちたけん	Rusted Sword	固有名詞	
くちたたて	Rusted Shield	固有名詞	
いかさまだいす	Loaded Dice	固有名詞	
おんみつまんと	Covert Cloak	固有名詞	
くりあちゃーむ	Clear Amulet	固有名詞	
とくせいがーど	Ability Shield	固有名詞	
ぱんちぐろーぶ	Punching Glove	固有名詞	
ぶーすとえなじー	Booster Energy	固有名詞	
ものまねはーぶ	Mirror Herb	固有名詞	
だいこんごうだま	Adamant Crystal	固有名詞	
だいしらたま	Lustrous Globe	固有名詞	
だいはっきんだま	Griseous Core	固有名詞	
ようせいのはね	Fairy Feather	固有名詞	
いどのめん	Wellspring Mask	固有名詞	
かまどのめん	Hearthflame Mask	固有名詞	
いしずえのめん	Cornerstone Mask	固有名詞	
もんすたーぼーる	Poké Ball	固有名詞	
すーぱーぼーる	Great Ball	固有名詞	
はいぱーぼーる	Ultra Ball	固有名詞	
ますたーぼーる	Master Ball	固有名詞	
さふぁりぼーる	Safari Ball	固有名詞	
へびーぼーる	Heavy Ball	固有名詞	
れべるぼーる	Level Ball	固有名詞	
るあーぼーる	Lure Ball	固有名詞	
すぴーどぼーる	Fast Ball	固有名詞	
ふれんどぼーる	Friend Ball	固有名詞	
むーんぼーる	Moon Ball	固有名詞	
らぶらぶぼーる	Love Ball	固有名詞	
こんぺぼーる	Sport Ball	固有名詞	
ねっとぼーる	Net Ball	固有名詞	
だいぶぼーる	Dive Ball	固有名詞	
ねすとぼーる	Nest Ball	固有名詞	
りぴーとぼーる	Repeat Ball	固有名詞	
たいまーぼーる	Timer Ball	固有名詞	
ごーじゃすぼーる	Luxury Ball	固有名詞	
ぷれみあぼーる	Premier Ball	固有名詞	
ひーるぼーる	Heal Ball	固有名詞	
だーくぼーる	Dusk Ball	固有名詞	
くいっくぼーる	Quick Ball	固有名詞	
ぱーくぼーる	Park Ball	固有名詞	
ぷれしゃすぼーる	Cherish Ball	固有名詞	
どりーむぼーる	Dream Ball	固有名詞	
うるとらぼーる	Beast Ball	固有名詞	
めがとんぼーる	Leaden Ball	固有名詞	
ぎがとんぼーる	Gigaton Ball	固有名詞	
ふぇざーぼーる	Feather Ball	固有名詞	
ういんぐぼーる	Wing Ball	固有名詞	
じぇっとぼーる	Jet Ball	固有名詞	
たいようのいし	Sun Stone	固有名詞	
つきのいし	Moon Stone	固有名詞	
ほのおのいし	Fire Stone	固有名詞	
かみなりのいし	Thunder Stone	固有名詞	
みずのいし	Water Stone	固有名詞	
りーふのいし	Leaf Stone	固有名詞	
ひかりのいし	Shiny Stone	固有名詞	
やみのいし	Dusk Stone	固有名詞	
めざめいし	Dawn Stone	固有名詞	
こおりのいし	Ice Stone	固有名詞	
すっぱいりんご	Tart Apple	固有名詞	
あまーいりんご	Sweet Apple	固有名詞	
われたぽっと	Cracked Pot	固有名詞	
かけたぽっと	Chipped Pot	固有名詞	
がらなつぶれす	Galarica Cuff	固有名詞	
がらなつりーす	Galarica Wreath	固有名詞	
いちごあめざいく	Strawberry Sweet	固有名詞	
はーとあめざいく	Love Sweet	固有名詞	
べりーあめざいく	Berry Sweet	固有名詞	
よつばあめざいく	Clover Sweet	固有名詞	
おはなあめざいく	Flower Sweet	固有名詞	
すたーあめざいく	Star Sweet	固有名詞	
りぼんあめざいく	Ribbon Sweet	固有名詞	
つながりのひも	Linking Cord	固有名詞	
くろのきせき	Black Augurite	固有名詞	
ぴーとぶろっく	Peat Block	固有名詞	
いわいのよろい	Auspicious Armor	固有名詞	
のろいのよろい	Malicious Armor	固有名詞	
みついりりんご	Syrupy Apple	固有名詞	
ぼんさくのちゃわん	Unremarkable Teacup	固有名詞	
けっさくのちゃわん	Masterpiece Teacup	固有名詞	
ふくごうきんぞく	Metal Alloy	固有名詞	
ちいさなきのこ	Tiny Mushroom	固有名詞	
おおきなきのこ	Big Mushroom	固有名詞	
しんじゅ	Pearl	固有名詞	
おおきなしんじゅ	Big Pearl	固有名詞	
ほしのすな	Stardust	固有名詞	
ほしのかけら	Star Piece	固有名詞	
きんのはっぱ	Gold Leaf	固有名詞	
ぎんのはっぱ	Silver Leaf	固有名詞	
かわらのかけら	Brick Piece	固有名詞	
きんのたま	Nugget	固有名詞	
きちょうなほね	Rare Bone	固有名詞	
きれいなはね	Pretty Wing	固有名詞	
かおるきのこ	Balm Mushroom	固有名詞	
でかいきんのたま	Big Nugget	固有名詞	
おだんごしんじゅ	Pearl String	固有名詞	
すいせいのかけら	Comet Shard	固有名詞	
こだいのどうか	Relic Copper	固有名詞	
こだいのぎんか	Relic Silver	固有名詞	
こだいのきんか	Relic Gold	固有名詞	
こだいのつぼ	Relic Vase	固有名詞	
こだいのうでわ	Relic Band	固有名詞	
こだいのせきぞう	Relic Statue	固有名詞	
こだいのおうかん	Relic Crown	固有名詞	
ぽけもんこけし	Pokéshi Doll	固有名詞	
ちいさなたけのこ	Tiny Bamboo Shoot	固有名詞	
おおきなたけのこ	Big Bamboo Shoot	固有名詞	
はながらめーる	Flower Mail	固有名詞	
なみのりめーる	Surf Mail	固有名詞	
みずいろめーる	Litebluemail	固有名詞	
にがおえめーる	Portraitmail	固有名詞	
らぶりーめーる	Lovely Mail	固有名詞	
ぶいぶいめーる	Eon Mail	固有名詞	
へんしんめーる	Morph Mail	固有名詞	
あおぞらめーる	Bluesky Mail	固有名詞	
おんぷめーる	Music Mail	固有名詞	
まぼろしめーる	Mirage Mail	固有名詞	
おれんじめーる	Orange Mail	固有名詞	
はーばーめーる	Harbor Mail	固有名詞	
きらきらめーる	Glitter Mail	固有名詞	
めかにかるめーる	Mech Mail	固有名詞	
うっでぃめーる	Wood Mail	固有名詞	
くろすめーる	Wave Mail	固有名詞	
とれじゃーめーる	Bead Mail	固有名詞	
しゃどーめーる	Shadow Mail	固有名詞	
とろぴかるめーる	Tropic Mail	固有名詞	
どりーむめーる	Dream Mail	固有名詞	
みらくるめーる	Fab Mail	固有名詞	
れとろめーる	Retro Mail	固有名詞	
ぐらすめーる	Grass Mail	固有名詞	
ふれいむめーる	Flame Mail	固有名詞	
ぶるーめーる	Bubble Mail	固有名詞	
ぶるーむめーる	Bloom Mail	固有名詞	
とんねるめーる	Tunnel Mail	固有名詞	
すちーるめーる	Steel Mail	固有名詞	
らぶらぶめーる	Heart Mail	固有名詞	
ぶりざーどめーる	Snow Mail	固有名詞	
すぺーすめーる	Space Mail	固有名詞	
えあめーる	Air Mail	固有名詞	
もざいくめーる	Mosaic Mail	固有名詞	
ぶりっくめーる	Brick Mail	固有名詞	
はじめてめーる	Greet Mail	固有名詞	
だいすきめーる	Favored Mail	固有名詞	
おさそいめーる	RSVP Mail	固有名詞	
かんしゃめーる	Thanks Mail	固有名詞	
しつもんめーる	Inquiry Mail	固有名詞	
おすすめめーる	Like Mail	固有名詞	
おかえしめーる	Reply Mail	固有名詞	
ぶりっじめーるえす	BridgeMail S	固有名詞	
ぶりっじめーるえいち	BridgeMail D	固有名詞	
ぶりっじめーるしー	BridgeMail T	固有名詞	
ぶりっじめーるぶい	BridgeMail V	固有名詞	
ぶりっじめーるだぶりゅー	BridgeMail M	固有名詞	
えふぇくとがーど	Guard Spec.	固有名詞	
くりてぃかっと	Dire Hit	固有名詞	
ぷらすぱわー	X Attack	固有名詞	
でぃふぇんだー	X Defend	固有名詞	
すぴーだー	X Speed	固有名詞	
よくあたーる	X Accuracy	固有名詞	
すぺしゃるあっぷ	X Special	固有名詞	
すぺしゃるがーど	X Sp. Def	固有名詞	
ぴっぴにんぎょう	Poké Doll	固有名詞	
えねこのしっぽ	Fluffy Tail	固有名詞	
あおいびーどろ	Blue Flute	固有名詞	
きいろびーどろ	Yellow Flute	固有名詞	
あかいびーどろ	Red Flute	固有名詞	
ぽけじゃらし	Poké Toy	固有名詞	
すきるこーる	Ability Urge	固有名詞	
あいてむどろっぷ	Item Drop	固有名詞	
あいてむこーる	Item Urge	固有名詞	
ふらっとこーる	Reset Urge	固有名詞	
びびりだま	Adrenaline Orb	固有名詞	
おうえんぽん	Roto Boost	固有名詞	
つかまえぽん	Roto Catch	固有名詞	
だいきのこ	Max Mushrooms	固有名詞	
きずぐすり	Potion	固有名詞	
どくけし	Antidote	固有名詞	
やけどなおし	Burn Heal	固有名詞	
こおりなおし	Ice Heal	固有名詞	
ねむけざまし	Awakening	固有名詞	
まひなおし	Parlyz Heal	固有名詞	
かいふくのくすり	Full Restore	固有名詞	
まんたんのくすり	Max Potion	固有名詞	
すごいきずぐすり	Hyper Potion	固有名詞	
いいきずぐすり	Super Potion	固有名詞	
なんでもなおし	Full Heal	固有名詞	
げんきのかけら	Revive	固有名詞	
げんきのかたまり	Max Revive	固有名詞	
おいしいみず	Fresh Water	固有名詞	
さいこそーだ	Soda Pop	固有名詞	
みっくすおれ	Lemonade	固有名詞	
ぴーぴーえいど	Ether	固有名詞	
ぴーぴーりかばー	Max Ether	固有名詞	
ぴーぴーえいだー	Elixir	固有名詞	
ぴーぴーまっくす	Max Elixir	固有名詞	
もーもーみるく	Moomoo Milk	固有名詞	
ちからのこな	Energy Powder	固有名詞	
ちからのねっこ	Energy Root	固有名詞	
ばんのうごな	Heal Powder	固有名詞	
ふっかつそう	Revival Herb	固有名詞	
せいなるはい	Sacred Ash	固有名詞	
いかりまんじゅう	Rage Candy Bar	固有名詞	
ふえんせんべい	Lava Cookie	固有名詞	
きのみじゅーす	Berry Juice	固有名詞	
ふしぎなあめ	Rare Candy	固有名詞	
ぽいんとあっぷ	PP Up	固有名詞	
ぽいんとまっくす	PP Max	固有名詞	
もりのようかん	Old Gateau	固有名詞	
はーとすいーつ	Sweet Heart	固有名詞	
ひうんあいす	Casteliacone	固有名詞	
みあれがれっと	Lumiose Galette	固有名詞	
しゃらさぶれ	Shalour Sable	固有名詞	
おおきいまらさだ	Big Malasada	固有名詞	
えいちぴーかいふくぽん	Roto HP Restore	固有名詞	
ぴーぴーかいふくぽん	Roto PP Restore	固有名詞	
にびあられ	Pewter Crunchies	固有名詞	
だいみつ	Max Honey	固有名詞	
ことぶきまふぃん	Jubilife Muffin	固有名詞	
かんぽーやく	Remedy	固有名詞	
いいかんぽーやく	Fine Remedy	固有名詞	
すごいかんぽーやく	Superb Remedy	固有名詞	
あらびきゔるすと	Sausages	固有名詞	
ぼぶのかんづめ	Bob's Food Tin	固有名詞	
ばっくのかんづめ	Bach's Food Tin	固有名詞	
まめかん	Tin of Beans	固有名詞	
しょくぱん	Bread	固有名詞	
ぱすた	Pasta	固有名詞	
きのこぱっく	Mixed Mushrooms	固有名詞	
しっぽのくんせい	Smoke-Poke Tail	固有名詞	
ふといながねぎ	Large Leek	固有名詞	
とくせんりんご	Fancy Apple	固有名詞	
かぼそいほね	Brittle Bones	固有名詞	
ぽてとぱっく	Pack of Potatoes	固有名詞	
みずべのはーぶ	Pungent Root	固有名詞	
やさいぱっく	Salad Mix	固有名詞	
ふらいもりあわせ	Fried Food	固有名詞	
ゆでたまご	Boiled Egg	固有名詞	
ふさぱっく	Fruit Bunch	固有名詞	
もーもーちーず	Moomoo Cheese	固有名詞	
すぱいすせっと	Spice Mix	固有名詞	
しんせんくりーむ	Fresh Cream	固有名詞	
れとるとかれー	Packaged Curry	固有名詞	
やしのみるく	Coconut Milk	固有名詞	
れとるとめん	Instant Noodles	固有名詞	
れとるとばーぐ	Precooked Burger	固有名詞	
きょだいぱうだー	Gigantamix	固有名詞	
まよねーず	Mayonnaise	固有名詞	
けちゃっぷ	Ketchup	固有名詞	
ますたーど	Mustard	固有名詞	
ばたー	Butter	固有名詞	
ぴーなっつばたー	Peanut Butter	固有名詞	
ちりそーす	Chili Sauce	固有名詞	
そると	Salt	固有名詞	
ぺっぱー	Pepper	固有名詞	
よーぐると	Yogurt	固有名詞	
ほいっぷくりーむ	Whipped Cream	固有名詞	
くりーむちーず	Cream Cheese	固有名詞	
べりーじゃむ	Jam	固有名詞	
まーまれーど	Marmalade	固有名詞	
おりーぶおいる	Olive Oil	固有名詞	
びねがー	Vinegar	固有名詞	
ひでん:あますぱいす	Sweet Herba Mystica	固有名詞	
ひでん:しおすぱいす	Salty Herba Mystica	固有名詞	
ひでん:すぱすぱいす	Sour Herba Mystica	固有名詞	
ひでん:にがすぱいす	Bitter Herba Mystica	固有名詞	
ひでん:からすぱいす	Spicy Herba Mystica	固有名詞	
ほーすらでぃっしゅ	Horseradish	固有名詞	
かれーぱうだー	Curry Powder	固有名詞	
わさびそーす	Wasabi	固有名詞	
れたす	Lettuce	固有名詞	
とまとすらいす	Tomato	固有名詞	
かっとみにとまと	Cherry Tomatoes	固有名詞	
きゅうりすらいす	Cucumber	固有名詞	
ぴくるすすらいす	Pickle	固有名詞	
たまねぎすらいす	Onion	固有名詞	
あーりーれっど	Red Onion	固有名詞	
ぴーまんすらいす	Green Bell Pepper	固有名詞	
あかぱぷりかすらいす	Red Bell Pepper	固有名詞	
きぱぷりかすらいす	Yellow Bell Pepper	固有名詞	
あぼかど	Avocado	固有名詞	
やきべーこん	Bacon	固有名詞	
はむすらいす	Ham	固有名詞	
なまはむ	Prosciutto	固有名詞	
やきちょりそー	Chorizo	固有名詞	
はーぶそーせーじ	Herbed Sausage	固有名詞	
はんばーぐ	Hamburger	固有名詞	
がけがにすてぃっく	Klawf Stick	固有名詞	
すもーくきりみ	Smoked Fillet	固有名詞	
きりみふらい	Fried Fillet	固有名詞	
すらいすえっぐ	Egg	固有名詞	
とるてぃーじゃ	Potato Tortilla	固有名詞	
とーふ	Tofu	固有名詞	
らいす	Rice	固有名詞	
ぬーどる	Noodles	固有名詞	
ぽてとさらだ	Potato Salad	固有名詞	
すらいすちーず	Cheese	固有名詞	
ばななすらいす	Banana	固有名詞	
いちごすらいす	Strawberry	固有名詞	
わぎりりんご	Apple	固有名詞	
わぎりきうい	Kiwi	固有名詞	
かっとぱいん	Pineapple	固有名詞	
はらぺーにょ	Jalapeño	固有名詞	
くれそん	Watercress	固有名詞	
ばじる	Basil	固有名詞	
ごーるどぴっく	Gold Pick	固有名詞	
しるばーぴっく	Silver Pick	固有名詞	
あかいはたぴっく	Red-Flag Pick	固有名詞	
あおいはたぴっく	Blue-Flag Pick	固有名詞	
ぴかぴかぴっく	Pika-Pika Pick	固有名詞	
ぱちぴかぴっく	Winking Pika Pick	固有名詞	
ぶいぶいぴっく	Vee-Vee Pick	固有名詞	
にこぶいぴっく	Smiling Vee Pick	固有名詞	
あおぼーるぴっく	Blue Poké Ball Pick	固有名詞	
みどりぼーるぴっく	Green Poké Ball Pick	固有名詞	
あかぼーるぴっく	Red Poké Ball Pick	固有名詞	
おいわいはなびぴっく	Party Sparkler Pick	固有名詞	
ゆうしゃのけんぴっく	Heroic Sword Pick	固有名詞	
まじかるすたーぴっく	Magical Star Pick	固有名詞	
まじかるはーとぴっく	Magical Heart Pick	固有名詞	
ぱらそるぴっく	Parasol Pick	固有名詞	
あおぞらおはなぴっく	Blue-Sky Flower Pick	固有名詞	
ゆうやけおはなぴっく	Sunset Flower Pick	固有名詞	
あさやけおはなぴっく	Sunrise Flower Pick	固有名詞	
むしよけすぷれー	Repel	固有名詞	
しるばーすぷれー	Super Repel	固有名詞	
ごーるどすぷれー	Max Repel	固有名詞	
あなぬけのひも	Escape Rope	固有名詞	
まっくすあっぷ	HP Up	固有名詞	
たうりん	Protein	固有名詞	
ぶろむへきしん	Iron	固有名詞	
りぞちうむ	Calcium	固有名詞	
きとさん	Zinc	固有名詞	
いんどめたしん	Carbos	固有名詞	
たいりょくのはね	Health Wing	固有名詞	
きんりょくのはね	Muscle Wing	固有名詞	
ていこうのはね	Resist Wing	固有名詞	
ちりょくのはね	Genius Wing	固有名詞	
せいしんのはね	Clever Wing	固有名詞	
しゅんぱつのはね	Swift Wing	固有名詞	
くろいびーどろ	Black Flute	固有名詞	
しろいびーどろ	White Flute	固有名詞	
あさせのしお	Shoal Salt	固有名詞	
あさせのかいがら	Shoal Shell	固有名詞	
はーとのうろこ	Heart Scale	固有名詞	
あかいかけら	Red Shard	固有名詞	
あおいかけら	Blue Shard	固有名詞	
きいろいかけら	Yellow Shard	固有名詞	
みどりのかけら	Green Shard	固有名詞	
がくしゅうそうち	Exp. Share	固有名詞	
きのはこ	Normal Box	固有名詞	
きりのはこ	Gorgeous Box	固有名詞	
おいしいしっぽ	SlowpokeTail	固有名詞	
あまいみつ	Honey	固有名詞	
ときのふえ	Time Flute	固有名詞	
ぽけまんま	Poké Snack	固有名詞	
すくすくこやし	Growth Mulch	固有名詞	
じめじめこやし	Damp Mulch	固有名詞	
ながながこやし	Stable Mulch	固有名詞	
ねばねばこやし	Gooey Mulch	固有名詞	
ねっこのかせき	Root Fossil	固有名詞	
つめのかせき	Claw Fossil	固有名詞	
かいのかせき	Helix Fossil	固有名詞	
こうらのかせき	Dome Fossil	固有名詞	
ひみつのこはく	Old Amber	固有名詞	
たてのかせき	Armor Fossil	固有名詞	
ずがいのかせき	Skull Fossil	固有名詞	
かなめいし	Odd Keystone	固有名詞	
ふたのかせき	Cover Fossil	固有名詞	
はねのかせき	Plume Fossil	固有名詞	
でるだま	Pass Orb	固有名詞	
とくせいかぷせる	Ability Capsule	固有名詞	
たわわこやし	Rich Mulch	固有名詞	
びっくりこやし	Surprise Mulch	固有名詞	
ぐんぐんこやし	Boost Mulch	固有名詞	
とんでもこやし	Amaze Mulch	固有名詞	
ばーげんちけっと	Discount Coupon	固有名詞	
ふしぎなおきもの	Strange Souvenir	固有名詞	
あごのかせき	Jaw Fossil	固有名詞	
ひれのかせき	Sail Fossil	固有名詞	
やまぶきのみつ	Yellow Nectar	固有名詞	
うすもものみつ	Pink Nectar	固有名詞	
くれないのみつ	Red Nectar	固有名詞	
むらさきのみつ	Purple Nectar	固有名詞	
ふぇすちけっと	Festival Ticket	固有名詞	
きんのおうかん	Gold Bottle Cap	固有名詞	
ぎんのおうかん	Bottle Cap	固有名詞	
たまごふかぽん	Roto Hatch	固有名詞	
やすうりぽん	Roto Bargain	固有名詞	
おこづかいぽん	Roto Prize Money	固有名詞	
けいけんぽん	Roto Exp. Points	固有名詞	
なつきぽん	Roto Friendship	固有名詞	
みっけぽん	Roto Encounter	固有名詞	
かくれぽん	Roto Stealth	固有名詞	
むしよせころん	Lure	固有名詞	
しるばーころん	Super Lure	固有名詞	
ごーるどころん	Max Lure	固有名詞	
ぎんのずりのみ	Silver Razz Berry	固有名詞	
きんのずりのみ	Golden Razz Berry	固有名詞	
ぎんのななのみ	Silver Nanab Berry	固有名詞	
きんのななのみ	Golden Nanab Berry	固有名詞	
ぎんのぱいるのみ	Silver Pinap Berry	固有名詞	
きんのぱいるのみ	Golden Pinap Berry	固有名詞	
うみべのがらす	Beach Glass	固有名詞	
かたっぽぴあす	Lone Earring	固有名詞	
このはのおてがみ	Leaf Letter	固有名詞	
ちいさなはなたば	Small Bouquet	固有名詞	
ちょーくいし	Chalky Stone	固有名詞	
なんごくかいがら	Tropical Shell	固有名詞	
のびたばね	Stretchy Spring	固有名詞	
びーだま	Marble	固有名詞	
ぴかぴかだんご	Polished Mud Ball	固有名詞	
ねがいのかたまり	Wishing Piece	固有名詞	
だいくりすたる	Dynamax Crystal	固有名詞	
だいまっくすあめ	Dynamax Candy	固有名詞	
けいけんあめえっくすえす	Exp. Candy XS	固有名詞	
けいけんあめえす	Exp. Candy S	固有名詞	
けいけんあめえむ	Exp. Candy M	固有名詞	
けいけんあめえる	Exp. Candy L	固有名詞	
けいけんあめえっくすえる	Exp. Candy XL	固有名詞	
さみしがりみんと	Lonely Mint	固有名詞	
いじっぱりみんと	Adamant Mint	固有名詞	
やんちゃみんと	Naughty Mint	固有名詞	
ゆうかんみんと	Brave Mint	固有名詞	
ずぶといみんと	Bold Mint	固有名詞	
わんぱくみんと	Impish Mint	固有名詞	
のうてんきみんと	Lax Mint	固有名詞	
のんきみんと	Relaxed Mint	固有名詞	
ひかえめみんと	Modest Mint	固有名詞	
おっとりみんと	Mild Mint	固有名詞	
うっかりやみんと	Rash Mint	固有名詞	
れいせいみんと	Quiet Mint	固有名詞	
おだやかみんと	Calm Mint	固有名詞	
おとなしいみんと	Gentle Mint	固有名詞	
しんちょうみんと	Careful Mint	固有名詞	
なまいきみんと	Sassy Mint	固有名詞	
おくびょうみんと	Timid Mint	固有名詞	
せっかちみんと	Hasty Mint	固有名詞	
ようきみんと	Jolly Mint	固有名詞	
むじゃきみんと	Naive Mint	固有名詞	
まじめみんと	Serious Mint	固有名詞	
かせきのとり	Fossilized Bird	固有名詞	
かせきのさかな	Fossilized Fish	固有名詞	
かせきのりゅう	Fossilized Drake	固有名詞	
かせきのくびなが	Fossilized Dino	固有名詞	
がらなつのえだ	Galarica Twig	固有名詞	
よろいこうせき	Armorite Ore	固有名詞	
あかぼんぐり	Red Apricorn	固有名詞	
あおぼんぐり	Blue Apricorn	固有名詞	
きぼんぐり	Yellow Apricorn	固有名詞	
みどぼんぐり	Green Apricorn	固有名詞	
ももぼんぐり	Pink Apricorn	固有名詞	
しろぼんぐり	White Apricorn	固有名詞	
くろぼんぐり	Black Apricorn	固有名詞	
とくせいぱっち	Ability Patch	固有名詞	
まっくすこうせき	Dynite Ore	固有名詞	
なぞのかけらえす	Mysterious Shard S	固有名詞	
なぞのかけらえる	Mysterious Shard L	固有名詞	
みちびきのせきばん	Discovery Slate	固有名詞	
じょうとのせきばん	Johto Slate	固有名詞	
かんとーのせきばん	Kanto Slate	固有名詞	
こころのせきばん	Soul Slate	固有名詞	
にじのせきばん	Rainbow Slate	固有名詞	
あらしのせきばん	Squall Slate	固有名詞	
たいかいのせきばん	Oceanic Slate	固有名詞	
たいりくのせきばん	Tectonic Slate	固有名詞	
てんくうのせきばん	Stratospheric Slate	固有名詞	
いでんしのせきばん	Genome Slate	固有名詞	
やぶれたせきばん	Distortion Slate	固有名詞	
せめのがんやく	Aux Power	固有名詞	
まもりのがんやく	Aux Guard	固有名詞	
よくあたらーぬ	Aux Evasion	固有名詞	
まるちあっぷ	Aux Powerguard	固有名詞	
こだわりちまき	Choice Dumpling	固有名詞	
にばいづけ	Twice-Spiced Radish	固有名詞	
あべこべやき	Swap Snack	固有名詞	
ひそやかすぷれー	Stealth Spray	固有名詞	
きのこよせだま	Mushroom Cake	固有名詞	
みつよせだま	Honey Cake	固有名詞	
いなほよせだま	Grain Cake	固有名詞	
まめよせだま	Bean Cake	固有名詞	
みねらるよせだま	Salt Cake	固有名詞	
めかくしだま	Smoke Bomb	固有名詞	
ばりばりだま	Scatter Bang	固有名詞	
ねばりだま	Sticky Glob	固有名詞	
どろだんご	Ball of Mud	固有名詞	
むしくいぼんぐり	Spoiled Apricorn	固有名詞	
もちもちきのこ	Springy Mushroom	固有名詞	
きらきらみつ	Dazzling Honey	固有名詞	
いきいきいなほ	Hearty Grains	固有名詞	
ころころまめ	Plump Beans	固有名詞	
ごりごりみねらる	Crunchy Salt	固有名詞	
ぼんぐりのみ	Apricorn	固有名詞	
たまいし	Tumblestone	固有名詞	
くろいろたまいし	Black Tumblestone	固有名詞	
そらいろたまいし	Sky Tumblestone	固有名詞	
てつのかけら	Iron Chunk	固有名詞	
かげぶんしめじ	Doppel Bonnets	固有名詞	
きゅうしょうろ	Direshroom	固有名詞	
きんぐりーふ	King's Leaf	固有名詞	
くすりそう	Medicinal Leek	固有名詞	
けむりいも	Sootfoot Root	固有名詞	
げんきのつぼみ	Vivichoke	固有名詞	
すいーととりゅふ	Candy Truffle	固有名詞	
すなはまだいこん	Sand Radish	固有名詞	
たまぜんまい	Caster Fern	固有名詞	
つるぎまいたけ	Swordcap	固有名詞	
てっぺきくらげ	Iron Barktongue	固有名詞	
ばりばりも	Pop Pod	固有名詞	
ぴーぴーぐさ	Pep-Up Plant	固有名詞	
むしよけそう	Bugwort	固有名詞	
もくざい	Wood	固有名詞	
よせだまのもと	Cake-Lure Base	固有名詞	
がんばりのすな	Grit Dust	固有名詞	
がんばりのじゃり	Grit Gravel	固有名詞	
がんばりのいし	Grit Pebble	固有名詞	
がんばりのいわ	Grit Rock	固有名詞	
かいでんのたね	Seed of Mastery	固有名詞	
みがわりおまもりいち	Tempting Charm R	固有名詞	
みがわりおまもりに	Tempting Charm B	固有名詞	
みがわりおまもりさん	Tempting Charm P	固有名詞	
みがわりおまもりよん	Tempting Charm T	固有名詞	
みがわりおまもりご	Tempting Charm Y	固有名詞	
あんぜんおまもりいち	Survival Charm R	固有名詞	
あんぜんおまもりに	Survival Charm B	固有名詞	
あんぜんおまもりさん	Survival Charm P	固有名詞	
あんぜんおまもりよん	Survival Charm T	固有名詞	
あんぜんおまもりご	Survival Charm Y	固有名詞	
けんこうおまもりいち	Warding Charm R	固有名詞	
けんこうおまもりに	Warding Charm B	固有名詞	
けんこうおまもりさん	Warding Charm P	固有名詞	
けんこうおまもりよん	Warding Charm T	固有名詞	
けんこうおまもりご	Warding Charm Y	固有名詞	
かしらのしるし	Leader's Crest	固有名詞	
てらぴーすのーまる	Normal Tera Shard	固有名詞	
てらぴーすほのお	Fire Tera Shard	固有名詞	
てらぴーすみず	Water Tera Shard	固有名詞	
てらぴーすくさ	Grass Tera Shard	固有名詞	
てらぴーすでんき	Electric Tera Shard	固有名詞	
てらぴーすこおり	Ice Tera Shard	固有名詞	
てらぴーすかくとう	Fighting Tera Shard	固有名詞	
てらぴーすどく	Poison Tera Shard	固有名詞	
てらぴーすじめん	Ground Tera Shard	固有名詞	
てらぴーすひこう	Flying Tera Shard	固有名詞	
てらぴーすえすぱー	Psychic Tera Shard	固有名詞	
てらぴーすむし	Bug Tera Shard	固有名詞	
てらぴーすいわ	Rock Tera Shard	固有名詞	
てらぴーすごーすと	Ghost Tera Shard	固有名詞	
てらぴーすどらごん	Dragon Tera Shard	固有名詞	
てらぴーすあく	Dark Tera Shard	固有名詞	
てらぴーすはがね	Steel Tera Shard	固有名詞	
てらぴーすふぇありー	Fairy Tera Shard	固有名詞	
てらぴーすすてら	Stellar Tera Shard	固有名詞	
たいりょくのもち	Health Mochi	固有名詞	
きんりょくのもち	Muscle Mochi	固有名詞	
ていこうのもち	Resist Mochi	固有名詞	
ちりょくのもち	Genius Mochi	固有名詞	
せいしんのもち	Clever Mochi	固有名詞	
しゅんぱつのもち	Swift Mochi	固有名詞	
まっさらもち	Fresh-Start Mochi	固有名詞	
