はたく	はたく	固有名詞	
からてちょっぷ	からてチョップ	固有名詞	
おうふくびんた	おうふくビンタ	固有名詞	
れんぞくぱんち	れんぞくパンチ	固有名詞	
めがとんぱんち	メガトンパンチ	固有名詞	
ねこにこばん	ネコにこばん	固有名詞	
ほのおのぱんち	ほのおのパンチ	固有名詞	
れいとうぱんち	れいとうパンチ	固有名詞	
かみなりぱんち	かみなりパンチ	固有名詞	
ひっかく	ひっかく	固有名詞	
はさむ	はさむ	固有名詞	
はさみぎろちん	ハサミギロチン	固有名詞	
かまいたち	かまいたち	固有名詞	
つるぎのまい	つるぎのまい	固有名詞	
いあいぎり	いあいぎり	固有名詞	
かぜおこし	かぜおこし	固有名詞	
つばさでうつ	つばさでうつ	固有名詞	
ふきとばし	ふきとばし	固有名詞	
そらをとぶ	そらをとぶ	固有名詞	
しめつける	しめつける	固有名詞	
たたきつける	たたきつける	固有名詞	
つるのむち	つるのムチ	固有名詞	
ふみつけ	ふみつけ	固有名詞	
にどげり	にどげり	固有名詞	
めがとんきっく	メガトンキック	固有名詞	
とびげり	とびげり	固有名詞	
まわしげり	まわしげり	固有名詞	
すなかけ	すなかけ	固有名詞	
ずつき	ずつき	固有名詞	
つのでつく	つのでつく	固有名詞	
みだれづき	みだれづき	固有名詞	
つのどりる	つのドリル	固有名詞	
たいあたり	たいあたり	固有名詞	
のしかかり	のしかかり	固有名詞	
まきつく	まきつく	固有名詞	
とっしん	とっしん	固有名詞	
あばれる	あばれる	固有名詞	
すてみたっくる	すてみタックル	固有名詞	
しっぽをふる	しっぽをふる	固有名詞	
どくばり	どくばり	固有名詞	
だぶるにーどる	ダブルニードル	固有名詞	
みさいるばり	ミサイルばり	固有名詞	
にらみつける	にらみつける	固有名詞	
かみつく	かみつく	固有名詞	
なきごえ	なきごえ	固有名詞	
ほえる	ほえる	固有名詞	
うたう	うたう	固有名詞	
ちょうおんぱ	ちょうおんぱ	固有名詞	
そにっくぶーむ	ソニックブーム	固有名詞	
かなしばり	かなしばり	固有名詞	
ようかいえき	ようかいえき	固有名詞	
ひのこ	ひのこ	固有名詞	
かえんほうしゃ	かえんほうしゃ	固有名詞	
しろいきり	しろいきり	固有名詞	
みずでっぽう	みずでっぽう	固有名詞	
はいどろぽんぷ	ハイドロポンプ	固有名詞	
なみのり	なみのり	固有名詞	
れいとうびーむ	れいとうビーム	固有名詞	
ふぶき	ふぶき	固有名詞	
さいけこうせん	サイケこうせん	固有名詞	
ばぶるこうせん	バブルこうせん	固有名詞	
おーろらびーむ	オーロラビーム	固有名詞	
はかいこうせん	はかいこうせん	固有名詞	
つつく	つつく	固有名詞	
どりるくちばし	ドリルくちばし	固有名詞	
じごくぐるま	じごくぐるま	固有名詞	
けたぐり	けたぐり	固有名詞	
かうんたー	カウンター	固有名詞	
ちきゅうなげ	ちきゅうなげ	固有名詞	
かいりき	かいりき	固有名詞	
すいとる	すいとる	固有名詞	
めがどれいん	メガドレイン	固有名詞	
やどりぎのたね	やどりぎのタネ	固有名詞	
せいちょう	せいちょう	固有名詞	
はっぱかったー	はっぱカッター	固有名詞	
そーらーびーむ	ソーラービーム	固有名詞	
どくのこな	どくのこな	固有名詞	
しびれごな	しびれごな	固有名詞	
ねむりごな	ねむりごな	固有名詞	
はなびらのまい	はなびらのまい	固有名詞	
いとをはく	いとをはく	固有名詞	
りゅうのいかり	りゅうのいかり	固有名詞	
ほのおのうず	ほのおのうず	固有名詞	
でんきしょっく	でんきショック	固有名詞	
じゅうまんぼると	10まんボルト	固有名詞	
でんじは	でんじは	固有名詞	
かみなり	かみなり	固有名詞	
いわおとし	いわおとし	固有名詞	
じしん	じしん	固有名詞	
じわれ	じわれ	固有名詞	
あなをほる	あなをほる	固有名詞	
どくどく	どくどく	固有名詞	
ねんりき	ねんりき	固有名詞	
さいこきねしす	サイコキネシス	固有名詞	
さいみんじゅつ	さいみんじゅつ	固有名詞	
よがのぽーず	ヨガのポーズ	固有名詞	
こうそくいどう	こうそくいどう	固有名詞	
でんこうせっか	でんこうせっか	固有名詞	
いかり	いかり	固有名詞	
てれぽーと	テレポート	固有名詞	
ないとへっど	ナイトヘッド	固有名詞	
ものまね	ものまね	固有名詞	
いやなおと	いやなおと	固有名詞	
かげぶんしん	かげぶんしん	固有名詞	
じこさいせい	じこさいせい	固有名詞	
かたくなる	かたくなる	固有名詞	
ちいさくなる	ちいさくなる	固有名詞	
えんまく	えんまく	固有名詞	
あやしいひかり	あやしいひかり	固有名詞	
からにこもる	からにこもる	固有名詞	
まるくなる	まるくなる	固有名詞	
ばりあー	バリアー	固有名詞	
ひかりのかべ	ひかりのかべ	固有名詞	
くろいきり	くろいきり	固有名詞	
りふれくたー	リフレクター	固有名詞	
きあいだめ	きあいだめ	固有名詞	
がまん	がまん	固有名詞	
ゆびをふる	ゆびをふる	固有名詞	
おうむがえし	オウムがえし	固有名詞	
じばく	じばく	固有名詞	
たまごばくだん	タマゴばくだん	固有名詞	
したでなめる	したでなめる	固有名詞	
すもっぐ	スモッグ	固有名詞	
へどろこうげき	ヘドロこうげき	固有名詞	
ほねこんぼう	ホネこんぼう	固有名詞	
だいもんじ	だいもんじ	固有名詞	
たきのぼり	たきのぼり	固有名詞	
からではさむ	からではさむ	固有名詞	
すぴーどすたー	スピードスター	固有名詞	
ろけっとずつき	ロケットずつき	固有名詞	
とげきゃのん	とげキャノン	固有名詞	
からみつく	からみつく	固有名詞	
どわすれ	ドわすれ	固有名詞	
すぷーんまげ	スプーンまげ	固有名詞	
たまごうみ	タマゴうみ	固有名詞	
とびひざげり	とびひざげり	固有名詞	
へびにらみ	へびにらみ	固有名詞	
ゆめくい	ゆめくい	固有名詞	
どくがす	どくガス	固有名詞	
たまなげ	たまなげ	固有名詞	
きゅうけつ	きゅうけつ	固有名詞	
あくまのきっす	あくまのキッス	固有名詞	
ごっどばーど	ゴッドバード	固有名詞	
へんしん	へんしん	固有名詞	
あわ	あわ	固有名詞	
ぴよぴよぱんち	ピヨピヨパンチ	固有名詞	
きのこのほうし	キノコのほうし	固有名詞	
ふらっしゅ	フラッシュ	固有名詞	
さいこうぇーぶ	サイコウェーブ	固有名詞	
はねる	はねる	固有名詞	
とける	とける	固有名詞	
くらぶはんまー	クラブハンマー	固有名詞	
だいばくはつ	だいばくはつ	固有名詞	
みだれひっかき	みだれひっかき	固有名詞	
ほねぶーめらん	ホネブーメラン	固有名詞	
ねむる	ねむる	固有名詞	
いわなだれ	いわなだれ	固有名詞	
ひっさつまえば	ひっさつまえば	固有名詞	
かくばる	かくばる	固有名詞	
てくすちゃー	テクスチャー	固有名詞	
とらいあたっく	トライアタック	固有名詞	
いかりのまえば	いかりのまえば	固有名詞	
きりさく	きりさく	固有名詞	
みがわり	みがわり	固有名詞	
わるあがき	わるあがき	固有名詞	
すけっち	スケッチ	固有名詞	
とりぷるきっく	トリプルキック	固有名詞	
どろぼう	どろぼう	固有名詞	
くものす	クモのす	固有名詞	
こころのめ	こころのめ	固有名詞	
あくむ	あくむ	固有名詞	
かえんぐるま	かえんぐるま	固有名詞	
いびき	いびき	固有名詞	
のろい	のろい	固有名詞	
じたばた	じたばた	固有名詞	
てくすちゃーに	テクスチャー2	固有名詞	
えあろぶらすと	エアロブラスト	固有名詞	
わたほうし	わたほうし	固有名詞	
きしかいせい	きしかいせい	固有名詞	
うらみ	うらみ	固有名詞	
こなゆき	こなゆき	固有名詞	
まもる	まもる	固有名詞	
まっはぱんち	マッハパンチ	固有名詞	
こわいかお	こわいかお	固有名詞	
だましうち	だましうち	固有名詞	
てんしのきっす	てんしのキッス	固有名詞	
はらだいこ	はらだいこ	固有名詞	
へどろばくだん	ヘドロばくだん	固有名詞	
どろかけ	どろかけ	固有名詞	
おくたんほう	オクタンほう	固有名詞	
まきびし	まきびし	固有名詞	
でんじほう	でんじほう	固有名詞	
みやぶる	みやぶる	固有名詞	
みちづれ	みちづれ	固有名詞	
ほろびのうた	ほろびのうた	固有名詞	
こごえるかぜ	こごえるかぜ	固有名詞	
みきり	みきり	固有名詞	
ぼーんらっしゅ	ボーンラッシュ	固有名詞	
ろっくおん	ロックオン	固有名詞	
げきりん	げきりん	固有名詞	
すなあらし	すなあらし	固有名詞	
ぎがどれいん	ギガドレイン	固有名詞	
こらえる	こらえる	固有名詞	
あまえる	あまえる	固有名詞	
ころがる	ころがる	固有名詞	
みねうち	みねうち	固有名詞	
いばる	いばる	固有名詞	
みるくのみ	ミルクのみ	固有名詞	
すぱーく	スパーク	固有名詞	
れんぞくぎり	れんぞくぎり	固有名詞	
はがねのつばさ	はがねのつばさ	固有名詞	
くろいまなざし	くろいまなざし	固有名詞	
めろめろ	メロメロ	固有名詞	
ねごと	ねごと	固有名詞	
いやしのすず	いやしのすず	固有名詞	
おんがえし	おんがえし	固有名詞	
ぷれぜんと	プレゼント	固有名詞	
やつあたり	やつあたり	固有名詞	
しんぴのまもり	しんぴのまもり	固有名詞	
いたみわけ	いたみわけ	固有名詞	
せいなるほのお	せいなるほのお	固有名詞	
まぐにちゅーど	マグニチュード	固有名詞	
ばくれつぱんち	ばくれつパンチ	固有名詞	
めがほーん	メガホーン	固有名詞	
りゅうのいぶき	りゅうのいぶき	固有名詞	
ばとんたっち	バトンタッチ	固有名詞	
あんこーる	アンコール	固有名詞	
おいうち	おいうち	固有名詞	
こうそくすぴん	こうそくスピン	固有名詞	
あまいかおり	あまいかおり	固有名詞	
あいあんてーる	アイアンテール	固有名詞	
めたるくろー	メタルクロー	固有名詞	
あてみなげ	あてみなげ	固有名詞	
あさのひざし	あさのひざし	固有名詞	
こうごうせい	こうごうせい	固有名詞	
つきのひかり	つきのひかり	固有名詞	
めざめるぱわー	めざめるパワー	固有名詞	
くろすちょっぷ	クロスチョップ	固有名詞	
たつまき	たつまき	固有名詞	
あまごい	あまごい	固有名詞	
にほんばれ	にほんばれ	固有名詞	
かみくだく	かみくだく	固有名詞	
みらーこーと	ミラーコート	固有名詞	
じこあんじ	じこあんじ	固有名詞	
しんそく	しんそく	固有名詞	
げんしのちから	げんしのちから	固有名詞	
しゃどーぼーる	シャドーボール	固有名詞	
みらいよち	みらいよち	固有名詞	
いわくだき	いわくだき	固有名詞	
うずしお	うずしお	固有名詞	
ふくろだたき	ふくろだたき	固有名詞	
ねこだまし	ねこだまし	固有名詞	
さわぐ	さわぐ	固有名詞	
たくわえる	たくわえる	固有名詞	
はきだす	はきだす	固有名詞	
のみこむ	のみこむ	固有名詞	
ねっぷう	ねっぷう	固有名詞	
あられ	あられ	固有名詞	
いちゃもん	いちゃもん	固有名詞	
おだてる	おだてる	固有名詞	
おにび	おにび	固有名詞	
おきみやげ	おきみやげ	固有名詞	
からげんき	からげんき	固有名詞	
きあいぱんち	きあいパンチ	固有名詞	
きつけ	きつけ	固有名詞	
このゆびとまれ	このゆびとまれ	固有名詞	
しぜんのちから	しぜんのちから	固有名詞	
じゅうでん	じゅうでん	固有名詞	
ちょうはつ	ちょうはつ	固有名詞	
てだすけ	てだすけ	固有名詞	
とりっく	トリック	固有名詞	
なりきり	なりきり	固有名詞	
ねがいごと	ねがいごと	固有名詞	
ねこのて	ねこのて	固有名詞	
ねをはる	ねをはる	固有名詞	
ばかぢから	ばかぢから	固有名詞	
まじっくこーと	マジックコート	固有名詞	
りさいくる	リサイクル	固有名詞	
りべんじ	リベンジ	固有名詞	
かわらわり	かわらわり	固有名詞	
あくび	あくび	固有名詞	
はたきおとす	はたきおとす	固有名詞	
がむしゃら	がむしゃら	固有名詞	
ふんか	ふんか	固有名詞	
すきるすわっぷ	スキルスワップ	固有名詞	
ふういん	ふういん	固有名詞	
りふれっしゅ	リフレッシュ	固有名詞	
おんねん	おんねん	固有名詞	
よこどり	よこどり	固有名詞	
ひみつのちから	ひみつのちから	固有名詞	
だいびんぐ	ダイビング	固有名詞	
つっぱり	つっぱり	固有名詞	
ほごしょく	ほごしょく	固有名詞	
ほたるび	ほたるび	固有名詞	
らすたーぱーじ	ラスターパージ	固有名詞	
みすとぼーる	ミストボール	固有名詞	
ふぇざーだんす	フェザーダンス	固有名詞	
ふらふらだんす	フラフラダンス	固有名詞	
ぶれいずきっく	ブレイズキック	固有名詞	
どろあそび	どろあそび	固有名詞	
あいすぼーる	アイスボール	固有名詞	
にーどるあーむ	ニードルアーム	固有名詞	
なまける	なまける	固有名詞	
はいぱーぼいす	ハイパーボイス	固有名詞	
どくどくのきば	どくどくのキバ	固有名詞	
ぶれいくくろー	ブレイククロー	固有名詞	
ぶらすとばーん	ブラストバーン	固有名詞	
はいどろかのん	ハイドロカノン	固有名詞	
こめっとぱんち	コメットパンチ	固有名詞	
おどろかす	おどろかす	固有名詞	
うぇざーぼーる	ウェザーボール	固有名詞	
あろませらぴー	アロマセラピー	固有名詞	
うそなき	うそなき	固有名詞	
えあかったー	エアカッター	固有名詞	
おーばーひーと	オーバーヒート	固有名詞	
かぎわける	かぎわける	固有名詞	
がんせきふうじ	がんせきふうじ	固有名詞	
ぎんいろのかぜ	ぎんいろのかぜ	固有名詞	
きんぞくおん	きんぞくおん	固有名詞	
くさぶえ	くさぶえ	固有名詞	
くすぐる	くすぐる	固有名詞	
こすもぱわー	コスモパワー	固有名詞	
しおふき	しおふき	固有名詞	
しぐなるびーむ	シグナルビーム	固有名詞	
しゃどーぱんち	シャドーパンチ	固有名詞	
じんつうりき	じんつうりき	固有名詞	
すかいあっぱー	スカイアッパー	固有名詞	
すなじごく	すなじごく	固有名詞	
ぜったいれいど	ぜったいれいど	固有名詞	
だくりゅう	だくりゅう	固有名詞	
たねましんがん	タネマシンガン	固有名詞	
つばめがえし	つばめがえし	固有名詞	
つららばり	つららばり	固有名詞	
てっぺき	てっぺき	固有名詞	
とおせんぼう	とおせんぼう	固有名詞	
とおぼえ	とおぼえ	固有名詞	
どらごんくろー	ドラゴンクロー	固有名詞	
はーどぷらんと	ハードプラント	固有名詞	
びるどあっぷ	ビルドアップ	固有名詞	
とびはねる	とびはねる	固有名詞	
まっどしょっと	マッドショット	固有名詞	
ぽいずんてーる	ポイズンテール	固有名詞	
ほしがる	ほしがる	固有名詞	
ぼるてっかー	ボルテッカー	固有名詞	
まじかるりーふ	マジカルリーフ	固有名詞	
みずあそび	みずあそび	固有名詞	
めいそう	めいそう	固有名詞	
りーふぶれーど	リーフブレード	固有名詞	
りゅうのまい	りゅうのまい	固有名詞	
ろっくぶらすと	ロックブラスト	固有名詞	
でんげきは	でんげきは	固有名詞	
みずのはどう	みずのはどう	固有名詞	
はめつのねがい	はめつのねがい	固有名詞	
さいこぶーすと	サイコブースト	固有名詞	
はねやすめ	はねやすめ	固有名詞	
じゅうりょく	じゅうりょく	固有名詞	
みらくるあい	ミラクルアイ	固有名詞	
めざましびんた	めざましビンタ	固有名詞	
あーむはんまー	アームハンマー	固有名詞	
じゃいろぼーる	ジャイロボール	固有名詞	
いやしのねがい	いやしのねがい	固有名詞	
しおみず	しおみず	固有名詞	
しぜんのめぐみ	しぜんのめぐみ	固有名詞	
ふぇいんと	フェイント	固有名詞	
ついばむ	ついばむ	固有名詞	
おいかぜ	おいかぜ	固有名詞	
つぼをつく	つぼをつく	固有名詞	
めたるばーすと	メタルバースト	固有名詞	
とんぼがえり	とんぼがえり	固有名詞	
いんふぁいと	インファイト	固有名詞	
しっぺがえし	しっぺがえし	固有名詞	
だめおし	ダメおし	固有名詞	
さしおさえ	さしおさえ	固有名詞	
なげつける	なげつける	固有名詞	
さいこしふと	サイコシフト	固有名詞	
きりふだ	きりふだ	固有名詞	
かいふくふうじ	かいふくふうじ	固有名詞	
しぼりとる	しぼりとる	固有名詞	
ぱわーとりっく	パワートリック	固有名詞	
いえき	いえき	固有名詞	
おまじない	おまじない	固有名詞	
さきどり	さきどり	固有名詞	
まねっこ	まねっこ	固有名詞	
ぱわーすわっぷ	パワースワップ	固有名詞	
がーどすわっぷ	ガードスワップ	固有名詞	
おしおき	おしおき	固有名詞	
とっておき	とっておき	固有名詞	
なやみのたね	なやみのタネ	固有名詞	
ふいうち	ふいうち	固有名詞	
どくびし	どくびし	固有名詞	
はーとすわっぷ	ハートスワップ	固有名詞	
あくありんぐ	アクアリング	固有名詞	
でんじふゆう	でんじふゆう	固有名詞	
ふれあどらいぶ	フレアドライブ	固有名詞	
はっけい	はっけい	固有名詞	
はどうだん	はどうだん	固有名詞	
ろっくかっと	ロックカット	固有名詞	
どくづき	どくづき	固有名詞	
あくのはどう	あくのはどう	固有名詞	
つじぎり	つじぎり	固有名詞	
あくあてーる	アクアテール	固有名詞	
たねばくだん	タネばくだん	固有名詞	
えあすらっしゅ	エアスラッシュ	固有名詞	
しざーくろす	シザークロス	固有名詞	
むしのさざめき	むしのさざめき	固有名詞	
りゅうのはどう	りゅうのはどう	固有名詞	
どらごんだいぶ	ドラゴンダイブ	固有名詞	
ぱわーじぇむ	パワージェム	固有名詞	
どれいんぱんち	ドレインパンチ	固有名詞	
しんくうは	しんくうは	固有名詞	
きあいだま	きあいだま	固有名詞	
えなじーぼーる	エナジーボール	固有名詞	
ぶれいぶばーど	ブレイブバード	固有名詞	
だいちのちから	だいちのちから	固有名詞	
すりかえ	すりかえ	固有名詞	
ぎがいんぱくと	ギガインパクト	固有名詞	
わるだくみ	わるだくみ	固有名詞	
ばれっとぱんち	バレットパンチ	固有名詞	
ゆきなだれ	ゆきなだれ	固有名詞	
こおりのつぶて	こおりのつぶて	固有名詞	
しゃどーくろー	シャドークロー	固有名詞	
かみなりのきば	かみなりのキバ	固有名詞	
こおりのきば	こおりのキバ	固有名詞	
ほのおのきば	ほのおのキバ	固有名詞	
かげうち	かげうち	固有名詞	
どろばくだん	どろばくだん	固有名詞	
さいこかったー	サイコカッター	固有名詞	
しねんのずつき	しねんのずつき	固有名詞	
みらーしょっと	ミラーショット	固有名詞	
らすたーかのん	ラスターカノン	固有名詞	
ろっくくらいむ	ロッククライム	固有名詞	
きりばらい	きりばらい	固有名詞	
とりっくるーむ	トリックルーム	固有名詞	
りゅうせいぐん	りゅうせいぐん	固有名詞	
ほうでん	ほうでん	固有名詞	
ふんえん	ふんえん	固有名詞	
りーふすとーむ	リーフストーム	固有名詞	
ぱわーうぃっぷ	パワーウィップ	固有名詞	
がんせきほう	がんせきほう	固有名詞	
くろすぽいずん	クロスポイズン	固有名詞	
だすとしゅーと	ダストシュート	固有名詞	
あいあんへっど	アイアンヘッド	固有名詞	
まぐねっとぼむ	マグネットボム	固有名詞	
すとーんえっじ	ストーンエッジ	固有名詞	
ゆうわく	ゆうわく	固有名詞	
すてるすろっく	ステルスロック	固有名詞	
くさむすび	くさむすび	固有名詞	
おしゃべり	おしゃべり	固有名詞	
さばきのつぶて	さばきのつぶて	固有名詞	
むしくい	むしくい	固有名詞	
ちゃーじびーむ	チャージビーム	固有名詞	
うっどはんまー	ウッドハンマー	固有名詞	
あくあじぇっと	アクアジェット	固有名詞	
こうげきしれい	こうげきしれい	固有名詞	
ぼうぎょしれい	ぼうぎょしれい	固有名詞	
かいふくしれい	かいふくしれい	固有名詞	
もろはのずつき	もろはのずつき	固有名詞	
だぶるあたっく	ダブルアタック	固有名詞	
ときのほうこう	ときのほうこう	固有名詞	
あくうせつだん	あくうせつだん	固有名詞	
みかづきのまい	みかづきのまい	固有名詞	
にぎりつぶす	にぎりつぶす	固有名詞	
まぐますとーむ	マグマストーム	固有名詞	
だーくほーる	ダークホール	固有名詞	
しーどふれあ	シードフレア	固有名詞	
あやしいかぜ	あやしいかぜ	固有名詞	
しゃどーだいぶ	シャドーダイブ	固有名詞	
つめとぎ	つめとぎ	固有名詞	
わいどがーど	ワイドガード	固有名詞	
がーどしぇあ	ガードシェア	固有名詞	
ぱわーしぇあ	パワーシェア	固有名詞	
わんだーるーむ	ワンダールーム	固有名詞	
さいこしょっく	サイコショック	固有名詞	
べのむしょっく	ベノムショック	固有名詞	
ぼでぃぱーじ	ボディパージ	固有名詞	
いかりのこな	いかりのこな	固有名詞	
てれきねしす	テレキネシス	固有名詞	
まじっくるーむ	マジックルーム	固有名詞	
うちおとす	うちおとす	固有名詞	
やまあらし	やまあらし	固有名詞	
はじけるほのお	はじけるほのお	固有名詞	
へどろうぇーぶ	ヘドロウェーブ	固有名詞	
ちょうのまい	ちょうのまい	固有名詞	
へびーぼんばー	ヘビーボンバー	固有名詞	
しんくろのいず	シンクロノイズ	固有名詞	
えれきぼーる	エレキボール	固有名詞	
みずびたし	みずびたし	固有名詞	
にとろちゃーじ	ニトロチャージ	固有名詞	
とぐろをまく	とぐろをまく	固有名詞	
ろーきっく	ローキック	固有名詞	
あしっどぼむ	アシッドボム	固有名詞	
いかさま	イカサマ	固有名詞	
しんぷるびーむ	シンプルビーム	固有名詞	
なかまづくり	なかまづくり	固有名詞	
おさきにどうぞ	おさきにどうぞ	固有名詞	
りんしょう	りんしょう	固有名詞	
えこーぼいす	エコーボイス	固有名詞	
なしくずし	なしくずし	固有名詞	
くりあすもっぐ	クリアスモッグ	固有名詞	
あしすとぱわー	アシストパワー	固有名詞	
ふぁすとがーど	ファストガード	固有名詞	
さいどちぇんじ	サイドチェンジ	固有名詞	
ねっとう	ねっとう	固有名詞	
からをやぶる	からをやぶる	固有名詞	
いやしのはどう	いやしのはどう	固有名詞	
たたりめ	たたりめ	固有名詞	
ふりーふぉーる	フリーフォール	固有名詞	
ぎあちぇんじ	ギアチェンジ	固有名詞	
ともえなげ	ともえなげ	固有名詞	
やきつくす	やきつくす	固有名詞	
さきおくり	さきおくり	固有名詞	
あくろばっと	アクロバット	固有名詞	
みらーたいぷ	ミラータイプ	固有名詞	
かたきうち	かたきうち	固有名詞	
いのちがけ	いのちがけ	固有名詞	
ぎふとぱす	ギフトパス	固有名詞	
れんごく	れんごく	固有名詞	
みずのちかい	みずのちかい	固有名詞	
ほのおのちかい	ほのおのちかい	固有名詞	
くさのちかい	くさのちかい	固有名詞	
ぼるとちぇんじ	ボルトチェンジ	固有名詞	
むしのていこう	むしのていこう	固有名詞	
じならし	じならし	固有名詞	
こおりのいぶき	こおりのいぶき	固有名詞	
どらごんてーる	ドラゴンテール	固有名詞	
ふるいたてる	ふるいたてる	固有名詞	
えれきねっと	エレキネット	固有名詞	
わいるどぼると	ワイルドボルト	固有名詞	
どりるらいなー	ドリルライナー	固有名詞	
だぶるちょっぷ	ダブルチョップ	固有名詞	
はーとすたんぷ	ハートスタンプ	固有名詞	
うっどほーん	ウッドホーン	固有名詞	
せいなるつるぎ	せいなるつるぎ	固有名詞	
しぇるぶれーど	シェルブレード	固有名詞	
ひーとすたんぷ	ヒートスタンプ	固有名詞	
ぐらすみきさー	グラスミキサー	固有名詞	
はーどろーらー	ハードローラー	固有名詞	
こっとんがーど	コットンガード	固有名詞	
ないとばーすと	ナイトバースト	固有名詞	
さいこぶれいく	サイコブレイク	固有名詞	
すいーぷびんた	スイープビンタ	固有名詞	
ぼうふう	ぼうふう	固有名詞	
あふろぶれいく	アフロブレイク	固有名詞	
ぎあそーさー	ギアソーサー	固有名詞	
かえんだん	かえんだん	固有名詞	
てくのばすたー	テクノバスター	固有名詞	
いにしえのうた	いにしえのうた	固有名詞	
しんぴのつるぎ	しんぴのつるぎ	固有名詞	
こごえるせかい	こごえるせかい	固有名詞	
らいげき	らいげき	固有名詞	
あおいほのお	あおいほのお	固有名詞	
ほのおのまい	ほのおのまい	固有名詞	
ふりーずぼると	フリーズボルト	固有名詞	
こーるどふれあ	コールドフレア	固有名詞	
ばーくあうと	バークアウト	固有名詞	
つららおとし	つららおとし	固有名詞	
Vじぇねれーと	Vジェネレート	固有名詞	
くろすふれいむ	クロスフレイム	固有名詞	
くろすさんだー	クロスサンダー	固有名詞	
ふらいんぐぷれす	フライングプレス	固有名詞	
たたみがえし	たたみがえし	固有名詞	
げっぷ	ゲップ	固有名詞	
たがやす	たがやす	固有名詞	
ねばねばねっと	ねばねばネット	固有名詞	
とどめばり	とどめばり	固有名詞	
ごーすとだいぶ	ゴーストダイブ	固有名詞	
はろうぃん	ハロウィン	固有名詞	
おたけび	おたけび	固有名詞	
ぷらずましゃわー	プラズマシャワー	固有名詞	
ぱらぼらちゃーじ	パラボラチャージ	固有名詞	
もりののろい	もりののろい	固有名詞	
はなふぶき	はなふぶき	固有名詞	
ふりーずどらい	フリーズドライ	固有名詞	
ちゃーむぼいす	チャームボイス	固有名詞	
すてぜりふ	すてゼリフ	固有名詞	
ひっくりかえす	ひっくりかえす	固有名詞	
どれいんきっす	ドレインキッス	固有名詞	
とりっくがーど	トリックガード	固有名詞	
ふらわーがーど	フラワーガード	固有名詞	
ぐらすふぃーるど	グラスフィールド	固有名詞	
みすとふぃーるど	ミストフィールド	固有名詞	
そうでん	そうでん	固有名詞	
じゃれつく	じゃれつく	固有名詞	
ようせいのかぜ	ようせいのかぜ	固有名詞	
むーんふぉーす	ムーンフォース	固有名詞	
ばくおんぱ	ばくおんぱ	固有名詞	
ふぇありーろっく	フェアリーロック	固有名詞	
きんぐしーるど	キングシールド	固有名詞	
なかよくする	なかよくする	固有名詞	
ないしょばなし	ないしょばなし	固有名詞	
だいやすとーむ	ダイヤストーム	固有名詞	
すちーむばーすと	スチームバースト	固有名詞	
いじげんほーる	いじげんホール	固有名詞	
みずしゅりけん	みずしゅりけん	固有名詞	
まじかるふれいむ	マジカルフレイム	固有名詞	
にーどるがーど	ニードルガード	固有名詞	
あろまみすと	アロマミスト	固有名詞	
かいでんぱ	かいでんぱ	固有名詞	
べのむとらっぷ	ベノムトラップ	固有名詞	
ふんじん	ふんじん	固有名詞	
じおこんとろーる	ジオコントロール	固有名詞	
じばそうさ	じばそうさ	固有名詞	
はっぴーたいむ	ハッピータイム	固有名詞	
えれきふぃーるど	エレキフィールド	固有名詞	
まじかるしゃいん	マジカルシャイン	固有名詞	
おいわい	おいわい	固有名詞	
てをつなぐ	てをつなぐ	固有名詞	
つぶらなひとみ	つぶらなひとみ	固有名詞	
ほっぺすりすり	ほっぺすりすり	固有名詞	
てかげん	てかげん	固有名詞	
まとわりつく	まとわりつく	固有名詞	
ぐろうぱんち	グロウパンチ	固有名詞	
ですういんぐ	デスウイング	固有名詞	
さうざんあろー	サウザンアロー	固有名詞	
さうざんうぇーぶ	サウザンウェーブ	固有名詞	
ぐらんどふぉーす	グランドフォース	固有名詞	
はめつのひかり	はめつのひかり	固有名詞	
こんげんのはどう	こんげんのはどう	固有名詞	
だんがいのつるぎ	だんがいのつるぎ	固有名詞	
がりょうてんせい	ガリョウテンセイ	固有名詞	
いじげんらっしゅ	いじげんラッシュ	固有名詞	
うるとらだっしゅあたっく	ウルトラダッシュアタック	固有名詞	
ぜんりょくむそうげきれつけん	ぜんりょくむそうげきれつけん	固有名詞	
ふぁいなるだいぶくらっしゅ	ファイナルダイブクラッシュ	固有名詞	
あしっどぽいずんでりーと	アシッドポイズンデリート	固有名詞	
らいじんぐらんどおーばー	ライジングランドオーバー	固有名詞	
わーるずえんどふぉーる	ワールズエンドフォール	固有名詞	
ぜったいほしょくかいてんざん	ぜったいほしょくかいてんざん	固有名詞	
むげんあんやへのいざない	むげんあんやへのいざない	固有名詞	
ちょうぜつらせんれんげき	ちょうぜつらせんれんげき	固有名詞	
だいなみっくふるふれいむ	ダイナミックフルフレイム	固有名詞	
すーぱーあくあとるねーど	スーパーアクアトルネード	固有名詞	
ぶるーむしゃいんえくすとら	ブルームシャインエクストラ	固有名詞	
すぱーきんぐぎがぼると	スパーキングギガボルト	固有名詞	
まきしまむさいぶれいかー	マキシマムサイブレイカー	固有名詞	
れいじんぐじおふりーず	レイジングジオフリーズ	固有名詞	
あるてぃめっとどらごんばーん	アルティメットドラゴンバーン	固有名詞	
ぶらっくほーるいくりぷす	ブラックホールイクリプス	固有名詞	
らぶりーすたーいんぱくと	ラブリースターインパクト	固有名詞	
ひっさつのぴかちゅーと	ひっさつのピカチュート	固有名詞	
すなあつめ	すなあつめ	固有名詞	
であいがしら	であいがしら	固有名詞	
とーちか	トーチカ	固有名詞	
かげぬい	かげぬい	固有名詞	
DDらりあっと	DDラリアット	固有名詞	
うたかたのありあ	うたかたのアリア	固有名詞	
あいすはんまー	アイスハンマー	固有名詞	
ふらわーひーる	フラワーヒール	固有名詞	
じゅうまんばりき	10まんばりき	固有名詞	
ちからをすいとる	ちからをすいとる	固有名詞	
そーらーぶれーど	ソーラーブレード	固有名詞	
このは	このは	固有名詞	
すぽっとらいと	スポットライト	固有名詞	
どくのいと	どくのいと	固有名詞	
とぎすます	とぎすます	固有名詞	
あしすとぎあ	アシストギア	固有名詞	
じごくづき	じごくづき	固有名詞	
かふんだんご	かふんだんご	固有名詞	
あんかーしょっと	アンカーショット	固有名詞	
さいこふぃーるど	サイコフィールド	固有名詞	
とびかかる	とびかかる	固有名詞	
ほのおのむち	ほのおのムチ	固有名詞	
つけあがる	つけあがる	固有名詞	
もえつきる	もえつきる	固有名詞	
すぴーどすわっぷ	スピードスワップ	固有名詞	
すまーとほーん	スマートホーン	固有名詞	
じょうか	じょうか	固有名詞	
めざめるだんす	めざめるダンス	固有名詞	
こあぱにっしゃー	コアパニッシャー	固有名詞	
とろぴかるきっく	トロピカルキック	固有名詞	
さいはい	さいはい	固有名詞	
くちばしきゃのん	くちばしキャノン	固有名詞	
すけいるのいず	スケイルノイズ	固有名詞	
どらごんはんまー	ドラゴンハンマー	固有名詞	
ぶんまわす	ぶんまわす	固有名詞	
おーろらべーる	オーロラベール	固有名詞	
しゃどーあろーずすとらいく	シャドーアローズストライク	固有名詞	
はいぱーだーくくらっしゃー	ハイパーダーククラッシャー	固有名詞	
わだつみのしんふぉにあ	わだつみのシンフォニア	固有名詞	
がーでぃあん・で・あろーら	ガーディアン・デ・アローラ	固有名詞	
しちせいだっこんたい	しちせいだっこんたい	固有名詞	
らいとにんぐさーふらいど	ライトニングサーフライド	固有名詞	
ほんきをだす こうげき	ほんきをだす こうげき	固有名詞	
ないんえぼるぶーすと	ナインエボルブースト	固有名詞	
おりじんずすーぱーのゔぁ	オリジンズスーパーノヴァ	固有名詞	
とらっぷしぇる	トラップシェル	固有名詞	
ふるーるかのん	フルールカノン	固有名詞	
さいこふぁんぐ	サイコファング	固有名詞	
じだんだ	じだんだ	固有名詞	
しゃどーぼーん	シャドーボーン	固有名詞	
あくせるろっく	アクセルロック	固有名詞	
あくあぶれいく	アクアブレイク	固有名詞	
ぷりずむれーざー	プリズムレーザー	固有名詞	
しゃどーすちーる	シャドースチール	固有名詞	
めておどらいぶ	メテオドライブ	固有名詞	
しゃどーれい	シャドーレイ	固有名詞	
なみだめ	なみだめ	固有名詞	
びりびりちくちく	びりびりちくちく	固有名詞	
しぜんのいかり	しぜんのいかり	固有名詞	
まるちあたっく	マルチアタック	固有名詞	
せんまんぼると	1000まんボルト	固有名詞	
ふぉとんげいざー	フォトンゲイザー	固有名詞	
びっくりへっど	ビックリヘッド	固有名詞	
ぷらずまふぃすと	プラズマフィスト	固有名詞	
ぶれいじんぐそうるびーと	ブレイジングソウルビート	固有名詞	
らじあるえっじすとーむ	ラジアルエッジストーム	固有名詞	
さんしゃいんすまっしゃー	サンシャインスマッシャー	固有名詞	
むーんらいとぶらすたー	ムーンライトブラスター	固有名詞	
てんこがすめつぼうのひかり	てんこがすめつぼうのひかり	固有名詞	
ぽかぼかふれんどたいむ	ぽかぼかフレンドタイム	固有名詞	
ばちばちあくせる	ばちばちアクセル	固有名詞	
ざぶざぶさーふ	ざぶざぶサーフ	固有名詞	
ふわふわふぉーる	ふわふわフォール	固有名詞	
ぴかぴかさんだー	ピカピカサンダー	固有名詞	
いきいきばぶる	いきいきバブル	固有名詞	
びりびりえれき	びりびりエレキ	固有名詞	
めらめらばーん	めらめらバーン	固有名詞	
どばどばおーら	どばどばオーラ	固有名詞	
わるわるぞーん	わるわるゾーン	固有名詞	
すくすくぼんばー	すくすくボンバー	固有名詞	
こちこちふろすと	こちこちフロスト	固有名詞	
きらきらすとーむ	きらきらストーム	固有名詞	
ぶいぶいぶれいく	ブイブイブレイク	固有名詞	
だぶるぱんつぁー	ダブルパンツァー	固有名詞	
だいあたっく	ダイアタック	固有名詞	
だいなっくる	ダイナックル	固有名詞	
だいじぇっと	ダイジェット	固有名詞	
だいあしっど	ダイアシッド	固有名詞	
だいあーす	ダイアース	固有名詞	
だいろっく	ダイロック	固有名詞	
だいわーむ	ダイワーム	固有名詞	
だいほろう	ダイホロウ	固有名詞	
だいすちる	ダイスチル	固有名詞	
だいばーん	ダイバーン	固有名詞	
だいすとりーむ	ダイストリーム	固有名詞	
だいそうげん	ダイソウゲン	固有名詞	
だいさんだー	ダイサンダー	固有名詞	
だいさいこ	ダイサイコ	固有名詞	
だいあいす	ダイアイス	固有名詞	
だいどらぐーん	ダイドラグーン	固有名詞	
だいあーく	ダイアーク	固有名詞	
だいふぇありー	ダイフェアリー	固有名詞	
だいうぉーる	ダイウォール	固有名詞	
きょだいべんたつ	キョダイベンタツ	固有名詞	
きょだいごくえん	キョダイゴクエン	固有名詞	
きょだいほうげき	キョダイホウゲキ	固有名詞	
きょだいこわく	キョダイコワク	固有名詞	
きょだいばんらい	キョダイバンライ	固有名詞	
きょだいこばん	キョダイコバン	固有名詞	
きょだいしんげき	キョダイシンゲキ	固有名詞	
きょだいげんえい	キョダイゲンエイ	固有名詞	
きょだいほうまつ	キョダイホウマツ	固有名詞	
きょだいせんりつ	キョダイセンリツ	固有名詞	
きょだいほーよー	キョダイホーヨー	固有名詞	
きょだいさいせい	キョダイサイセイ	固有名詞	
きょだいしゅうき	キョダイシュウキ	固有名詞	
きょだいゆうげき	キョダイユウゲキ	固有名詞	
きょだいこらんだ	キョダイコランダ	固有名詞	
きょだいかきゅう	キョダイカキュウ	固有名詞	
きょだいそげき	キョダイソゲキ	固有名詞	
きょだいふうげき	キョダイフウゲキ	固有名詞	
きょだいてんどう	キョダイテンドウ	固有名詞	
きょだいがんじん	キョダイガンジン	固有名詞	
きょだいふんせき	キョダイフンセキ	固有名詞	
きょだいさんげき	キョダイサンゲキ	固有名詞	
きょだいかんろ	キョダイカンロ	固有名詞	
きょだいさじん	キョダイサジン	固有名詞	
きょだいかんでん	キョダイカンデン	固有名詞	
きょだいひゃっか	キョダイヒャッカ	固有名詞	
きょだいてんばつ	キョダイテンバツ	固有名詞	
きょだいすいま	キョダイスイマ	固有名詞	
きょだいだんえん	キョダイダンエン	固有名詞	
きょだいこうじん	キョダイコウジン	固有名詞	
きょだいげんすい	キョダイゲンスイ	固有名詞	
きょだいいちげき	キョダイイチゲキ	固有名詞	
きょだいれんげき	キョダイレンゲキ	固有名詞	
Gのちから	Gのちから	固有名詞	
あいあんろーらー	アイアンローラー	固有名詞	
あすとらるびっと	アストラルビット	固有名詞	
あんこくきょうだ	あんこくきょうだ	固有名詞	
いてつくしせん	いてつくしせん	固有名詞	
いのちのしずく	いのちのしずく	固有名詞	
うっぷんばらし	うっぷんばらし	固有名詞	
えだづき	えだづき	固有名詞	
えらがみ	エラがみ	固有名詞	
おーばーどらいぶ	オーバードライブ	固有名詞	
おーらぐるま	オーラぐるま	固有名詞	
おちゃかい	おちゃかい	固有名詞	
かえんぼーる	かえんボール	固有名詞	
きょじゅうざん	きょじゅうざん	固有名詞	
きょじゅうだん	きょじゅうだん	固有名詞	
くいっくたーん	クイックターン	固有名詞	
くらいつく	くらいつく	固有名詞	
ぐらすすらいだー	グラススライダー	固有名詞	
こーちんぐ	コーチング	固有名詞	
こーとちぇんじ	コートチェンジ	固有名詞	
さんだーぷりずん	サンダープリズン	固有名詞	
しぇるあーむず	シェルアームズ	固有名詞	
しっとのほのお	しっとのほのお	固有名詞	
じゃんぐるひーる	ジャングルヒール	固有名詞	
すいりゅうれんだ	すいりゅうれんだ	固有名詞	
すけいるしょっと	スケイルショット	固有名詞	
すたーあさると	スターアサルト	固有名詞	
そうるくらっしゅ	ソウルクラッシュ	固有名詞	
そうるびーと	ソウルビート	固有名詞	
たーるしょっと	タールショット	固有名詞	
だいちのはどう	だいちのはどう	固有名詞	
だいまっくすほう	ダイマックスほう	固有名詞	
たこがため	たこがため	固有名詞	
だぶるういんぐ	ダブルウイング	固有名詞	
でこれーしょん	デコレーション	固有名詞	
てっていこうせん	てっていこうせん	固有名詞	
でんげきくちばし	でんげきくちばし	固有名詞	
どげざつき	どげざつき	固有名詞	
どらごんあろー	ドラゴンアロー	固有名詞	
どらごんえなじー	ドラゴンエナジー	固有名詞	
とらばさみ	トラバサミ	固有名詞	
どらむあたっく	ドラムアタック	固有名詞	
とりぷるあくせる	トリプルアクセル	固有名詞	
ねっさのだいち	ねっさのだいち	固有名詞	
ねらいうち	ねらいうち	固有名詞	
はいすいのじん	はいすいのじん	固有名詞	
はいよるいちげき	はいよるいちげき	固有名詞	
ぶきみなじゅもん	ぶきみなじゅもん	固有名詞	
ふしょくがす	ふしょくガス	固有名詞	
ぶりざーどらんす	ブリザードランス	固有名詞	
ぶろっきんぐ	ブロッキング	固有名詞	
ほおばる	ほおばる	固有名詞	
ぼでぃぷれす	ボディプレス	固有名詞	
ぽるたーがいすと	ポルターガイスト	固有名詞	
まほうのこな	まほうのこな	固有名詞	
みすとばーすと	ミストバースト	固有名詞	
むげんだいびーむ	ムゲンダイビーム	固有名詞	
めておびーむ	メテオビーム	固有名詞	
もえあがるいかり	もえあがるいかり	固有名詞	
らいじんぐぼると	ライジングボルト	固有名詞	
らいめいげり	らいめいげり	固有名詞	
りんごさん	りんごさん	固有名詞	
わいどふぉーす	ワイドフォース	固有名詞	
わいどぶれいかー	ワイドブレイカー	固有名詞	
わんだーすちーむ	ワンダースチーム	固有名詞	
ふぇいたるくろー	フェイタルクロー	固有名詞	
ばりあーらっしゅ	バリアーラッシュ	固有名詞	
ぱわーしふと	パワーシフト	固有名詞	
がんせきあっくす	がんせきアックス	固有名詞	
はるのあらし	はるのあらし	固有名詞	
しんぴのちから	しんぴのちから	固有名詞	
だいふんげき	だいふんげき	固有名詞	
うぇーぶたっくる	ウェーブタックル	固有名詞	
くろろぶらすと	クロロブラスト	固有名詞	
ひょうざんおろし	ひょうざんおろし	固有名詞	
しょうりのまい	しょうりのまい	固有名詞	
ぶちかまし	ぶちかまし	固有名詞	
どくばりせんぼん	どくばりセンボン	固有名詞	
おーらういんぐ	オーラウイング	固有名詞	
うらみつらみ	うらみつらみ	固有名詞	
たてこもる	たてこもる	固有名詞	
さんぼんのや	3ぼんのや	固有名詞	
ひゃっきやこう	ひゃっきやこう	固有名詞	
ひけん・ちえなみ	ひけん・ちえなみ	固有名詞	
こがらしあらし	こがらしあらし	固有名詞	
かみなりあらし	かみなりあらし	固有名詞	
ねっさのあらし	ねっさのあらし	固有名詞	
みかづきのいのり	みかづきのいのり	固有名詞	
ぶれいぶちゃーじ	ブレイブチャージ	固有名詞	
あーまーきゃのん	アーマーキャノン	固有名詞	
あいすすぴなー	アイススピナー	固有名詞	
あくあかったー	アクアカッター	固有名詞	
あくあすてっぷ	アクアステップ	固有名詞	
あくせるぶれいく	アクセルブレイク	固有名詞	
いっちょうあがり	いっちょうあがり	固有名詞	
いなずまどらいぶ	イナズマドライブ	固有名詞	
うつしえ	うつしえ	固有名詞	
えれくとろびーむ	エレクトロビーム	固有名詞	
おかたづけ	おかたづけ	固有名詞	
おはかまいり	おはかまいり	固有名詞	
かえんのまもり	かえんのまもり	固有名詞	
かかとおとし	かかとおとし	固有名詞	
かたすとろふぃ	カタストロフィ	固有名詞	
きまぐれーざー	きまぐレーザー	固有名詞	
きょけんとつげき	きょけんとつげき	固有名詞	
きらーすぴん	キラースピン	固有名詞	
くさわけ	くさわけ	固有名詞	
ごーるどらっしゅ	ゴールドラッシュ	固有名詞	
さいきのいのり	さいきのいのり	固有名詞	
さいこのいず	サイコノイズ	固有名詞	
さいこぶれいど	サイコブレイド	固有名詞	
さむいぎゃぐ	さむいギャグ	固有名詞	
さんだーだいぶ	サンダーダイブ	固有名詞	
じぇっとぱんち	ジェットパンチ	固有名詞	
しおづけ	しおづけ	固有名詞	
しっぽきり	しっぽきり	固有名詞	
しゃかしゃかほう	シャカシャカほう	固有名詞	
じゃどくのくさり	じゃどくのくさり	固有名詞	
じんらい	じんらい	固有名詞	
すれっどとらっぷ	スレッドトラップ	固有名詞	
たきおんかったー	タキオンカッター	固有名詞	
ついんびーむ	ツインビーム	固有名詞	
つたこんぼう	ツタこんぼう	固有名詞	
でかはんまー	デカハンマー	固有名詞	
てらくらすたー	テラクラスター	固有名詞	
てらばーすと	テラバースト	固有名詞	
でんこうそうげき	でんこうそうげき	固有名詞	
どげざん	ドゲザン	固有名詞	
とびつく	とびつく	固有名詞	
どらごんえーる	ドラゴンエール	固有名詞	
とりっくふらわー	トリックフラワー	固有名詞	
とりぷるだいぶ	トリプルダイブ	固有名詞	
ねずみざん	ネズミざん	固有名詞	
はーどぷれす	ハードプレス	固有名詞	
はいどろすちーむ	ハイドロスチーム	固有名詞	
はいぱーどりる	ハイパードリル	固有名詞	
はばねろえきす	ハバネロエキス	固有名詞	
はやてがえし	はやてがえし	固有名詞	
ぱわふるえっじ	パワフルエッジ	固有名詞	
ひやみず	ひやみず	固有名詞	
ぶらっどむーん	ブラッドムーン	固有名詞	
ふれあそんぐ	フレアソング	固有名詞	
ふんどのこぶし	ふんどのこぶし	固有名詞	
ほいーるすぴん	ホイールスピン	固有名詞	
ほうふく	ほうふく	固有名詞	
みずあめぼむ	みずあめボム	固有名詞	
みわくのぼいす	みわくのボイス	固有名詞	
みをけずる	みをけずる	固有名詞	
むねんのつるぎ	むねんのつるぎ	固有名詞	
やけっぱち	やけっぱち	固有名詞	
ゆきげしき	ゆきげしき	固有名詞	
るみなこりじょん	ルミナコリジョン	固有名詞	
れいじんぐぶる	レイジングブル	固有名詞	
だーくあくせる	ダークアクセル	固有名詞	
ばーんあくせる	バーンアクセル	固有名詞	
ぽいずんあくせる	ポイズンアクセル	固有名詞	
まじかるあくせる	マジカルアクセル	固有名詞	
ふぁいとあくせる	ファイトアクセル	固有名詞	
