ふしぎだね	Bulbasaur	固有名詞	
ふしぎそう	Ivysaur	固有名詞	
ふしぎばな	Venusaur	固有名詞	
ひとかげ	Charmander	固有名詞	
りざーど	Charmeleon	固有名詞	
りざーどん	Charizard	固有名詞	
ぜにがめ	Squirtle	固有名詞	
かめーる	Wartortle	固有名詞	
かめっくす	Blastoise	固有名詞	
きゃたぴー	Caterpie	固有名詞	
とらんせる	Metapod	固有名詞	
ばたふりー	Butterfree	固有名詞	
びーどる	Weedle	固有名詞	
こくーん	Kakuna	固有名詞	
すぴあー	Beedrill	固有名詞	
ぽっぽ	Pidgey	固有名詞	
ぴじょん	Pidgeotto	固有名詞	
ぴじょっと	Pidgeot	固有名詞	
こらった	Rattata	固有名詞	
らった	Raticate	固有名詞	
おにすずめ	Spearow	固有名詞	
おにどりる	Fearow	固有名詞	
あーぼ	Ekans	固有名詞	
あーぼっく	Arbok	固有名詞	
ぴかちゅう	Pikachu	固有名詞	
らいちゅう	Raichu	固有名詞	
さんど	Sandshrew	固有名詞	
さんどぱん	Sandslash	固有名詞	
にどらん♀	Nidoran♀	固有名詞	
にどりーな	Nidorina	固有名詞	
にどくいん	Nidoqueen	固有名詞	
にどらん♂	Nidoran♂	固有名詞	
にどりーの	Nidorino	固有名詞	
にどきんぐ	Nidoking	固有名詞	
ぴっぴ	Clefairy	固有名詞	
ぴくしー	Clefable	固有名詞	
ろこん	Vulpix	固有名詞	
きゅうこん	Ninetales	固有名詞	
ぷりん	Jigglypuff	固有名詞	
ぷくりん	Wigglytuff	固有名詞	
ずばっと	Zubat	固有名詞	
ごるばっと	Golbat	固有名詞	
なぞのくさ	Oddish	固有名詞	
くさいはな	Gloom	固有名詞	
らふれしあ	Vileplume	固有名詞	
ぱらす	Paras	固有名詞	
ぱらせくと	Parasect	固有名詞	
こんぱん	Venonat	固有名詞	
もるふぉん	Venomoth	固有名詞	
でぃぐだ	Diglett	固有名詞	
だぐとりお	Dugtrio	固有名詞	
にゃーす	Meowth	固有名詞	
ぺるしあん	Persian	固有名詞	
こだっく	Psyduck	固有名詞	
ごるだっく	Golduck	固有名詞	
まんきー	Mankey	固有名詞	
おこりざる	Primeape	固有名詞	
がーでぃ	Growlithe	固有名詞	
ういんでぃ	Arcanine	固有名詞	
にょろも	Poliwag	固有名詞	
にょろぞ	Poliwhirl	固有名詞	
にょろぼん	Poliwrath	固有名詞	
けーしぃ	Abra	固有名詞	
ゆんげらー	Kadabra	固有名詞	
ふーでぃん	Alakazam	固有名詞	
わんりきー	Machop	固有名詞	
ごーりきー	Machoke	固有名詞	
かいりきー	Machamp	固有名詞	
まだつぼみ	Bellsprout	固有名詞	
うつどん	Weepinbell	固有名詞	
うつぼっと	Victreebel	固有名詞	
めのくらげ	Tentacool	固有名詞	
どくくらげ	Tentacruel	固有名詞	
いしつぶて	Geodude	固有名詞	
ごろーん	Graveler	固有名詞	
ごろーにゃ	Golem	固有名詞	
ぽにーた	Ponyta	固有名詞	
ぎゃろっぷ	Rapidash	固有名詞	
やどん	Slowpoke	固有名詞	
やどらん	Slowbro	固有名詞	
こいる	Magnemite	固有名詞	
れあこいる	Magneton	固有名詞	
かもねぎ	Farfetch'd	固有名詞	
どーどー	Doduo	固有名詞	
どーどりお	Dodrio	固有名詞	
ぱうわう	Seel	固有名詞	
じゅごん	Dewgong	固有名詞	
べとべたー	Grimer	固有名詞	
べとべとん	Muk	固有名詞	
しぇるだー	Shellder	固有名詞	
ぱるしぇん	Cloyster	固有名詞	
ごーす	Gastly	固有名詞	
ごーすと	Haunter	固有名詞	
げんがー	Gengar	固有名詞	
いわーく	Onix	固有名詞	
すりーぷ	Drowzee	固有名詞	
すりーぱー	Hypno	固有名詞	
くらぶ	Krabby	固有名詞	
きんぐらー	Kingler	固有名詞	
びりりだま	Voltorb	固有名詞	
まるまいん	Electrode	固有名詞	
たまたま	Exeggcute	固有名詞	
なっしー	Exeggutor	固有名詞	
からから	Cubone	固有名詞	
がらがら	Marowak	固有名詞	
さわむらー	Hitmonlee	固有名詞	
えびわらー	Hitmonchan	固有名詞	
べろりんが	Lickitung	固有名詞	
どがーす	Koffing	固有名詞	
またどがす	Weezing	固有名詞	
さいほーん	Rhyhorn	固有名詞	
さいどん	Rhydon	固有名詞	
らっきー	Chansey	固有名詞	
もんじゃら	Tangela	固有名詞	
がるーら	Kangaskhan	固有名詞	
たっつー	Horsea	固有名詞	
しーどら	Seadra	固有名詞	
とさきんと	Goldeen	固有名詞	
あずまおう	Seaking	固有名詞	
ひとでまん	Staryu	固有名詞	
すたーみー	Starmie	固有名詞	
ばりやーど	Mr. Mime	固有名詞	
すとらいく	Scyther	固有名詞	
るーじゅら	Jynx	固有名詞	
えれぶー	Electabuzz	固有名詞	
ぶーばー	Magmar	固有名詞	
かいろす	Pinsir	固有名詞	
けんたろす	Tauros	固有名詞	
こいきんぐ	Magikarp	固有名詞	
ぎゃらどす	Gyarados	固有名詞	
らぷらす	Lapras	固有名詞	
めたもん	Ditto	固有名詞	
いーぶい	Eevee	固有名詞	
しゃわーず	Vaporeon	固有名詞	
さんだーす	Jolteon	固有名詞	
ぶーすたー	Flareon	固有名詞	
ぽりごん	Porygon	固有名詞	
おむないと	Omanyte	固有名詞	
おむすたー	Omastar	固有名詞	
かぶと	Kabuto	固有名詞	
かぶとぷす	Kabutops	固有名詞	
ぷてら	Aerodactyl	固有名詞	
かびごん	Snorlax	固有名詞	
ふりーざー	Articuno	固有名詞	
さんだー	Zapdos	固有名詞	
ふぁいやー	Moltres	固有名詞	
みにりゅう	Dratini	固有名詞	
はくりゅー	Dragonair	固有名詞	
かいりゅー	Dragonite	固有名詞	
みゅうつー	Mewtwo	固有名詞	
みゅう	Mew	固有名詞	
ちこりーた	Chikorita	固有名詞	
べいりーふ	Bayleef	固有名詞	
めがにうむ	Meganium	固有名詞	
ひのあらし	Cyndaquil	固有名詞	
まぐまらし	Quilava	固有名詞	
ばくふーん	Typhlosion	固有名詞	
わにのこ	Totodile	固有名詞	
ありげいつ	Croconaw	固有名詞	
おーだいる	Feraligatr	固有名詞	
おたち	Sentret	固有名詞	
おおたち	Furret	固有名詞	
ほーほー	Hoothoot	固有名詞	
よるのずく	Noctowl	固有名詞	
れでぃば	Ledyba	固有名詞	
れでぃあん	Ledian	固有名詞	
いとまる	Spinarak	固有名詞	
ありあどす	Ariados	固有名詞	
くろばっと	Crobat	固有名詞	
ちょんちー	Chinchou	固有名詞	
らんたーん	Lanturn	固有名詞	
ぴちゅー	Pichu	固有名詞	
ぴぃ	Cleffa	固有名詞	
ぷぷりん	Igglybuff	固有名詞	
とげぴー	Togepi	固有名詞	
とげちっく	Togetic	固有名詞	
ねいてぃ	Natu	固有名詞	
ねいてぃお	Xatu	固有名詞	
めりーぷ	Mareep	固有名詞	
もここ	Flaaffy	固有名詞	
でんりゅう	Ampharos	固有名詞	
きれいはな	Bellossom	固有名詞	
まりる	Marill	固有名詞	
まりるり	Azumarill	固有名詞	
うそっきー	Sudowoodo	固有名詞	
にょろとの	Politoed	固有名詞	
はねっこ	Hoppip	固有名詞	
ぽぽっこ	Skiploom	固有名詞	
わたっこ	Jumpluff	固有名詞	
えいぱむ	Aipom	固有名詞	
ひまなっつ	Sunkern	固有名詞	
きまわり	Sunflora	固有名詞	
やんやんま	Yanma	固有名詞	
うぱー	Wooper	固有名詞	
ぬおー	Quagsire	固有名詞	
えーふぃ	Espeon	固有名詞	
ぶらっきー	Umbreon	固有名詞	
やみからす	Murkrow	固有名詞	
やどきんぐ	Slowking	固有名詞	
むうま	Misdreavus	固有名詞	
あんのーん	Unown	固有名詞	
そーなんす	Wobbuffet	固有名詞	
きりんりき	Girafarig	固有名詞	
くぬぎだま	Pineco	固有名詞	
ふぉれとす	Forretress	固有名詞	
のこっち	Dunsparce	固有名詞	
ぐらいがー	Gligar	固有名詞	
はがねーる	Steelix	固有名詞	
ぶるー	Snubbull	固有名詞	
ぐらんぶる	Granbull	固有名詞	
はりーせん	Qwilfish	固有名詞	
はっさむ	Scizor	固有名詞	
つぼつぼ	Shuckle	固有名詞	
へらくろす	Heracross	固有名詞	
にゅーら	Sneasel	固有名詞	
ひめぐま	Teddiursa	固有名詞	
りんぐま	Ursaring	固有名詞	
まぐまっぐ	Slugma	固有名詞	
まぐかるご	Magcargo	固有名詞	
うりむー	Swinub	固有名詞	
いのむー	Piloswine	固有名詞	
さにーご	Corsola	固有名詞	
てっぽうお	Remoraid	固有名詞	
おくたん	Octillery	固有名詞	
でりばーど	Delibird	固有名詞	
まんたいん	Mantine	固有名詞	
えあーむど	Skarmory	固有名詞	
でるびる	Houndour	固有名詞	
へるがー	Houndoom	固有名詞	
きんぐどら	Kingdra	固有名詞	
ごまぞう	Phanpy	固有名詞	
どんふぁん	Donphan	固有名詞	
ぽりごんに	Porygon2	固有名詞	
おどしし	Stantler	固有名詞	
どーぶる	Smeargle	固有名詞	
ばるきー	Tyrogue	固有名詞	
かぽえらー	Hitmontop	固有名詞	
むちゅーる	Smoochum	固有名詞	
えれきっど	Elekid	固有名詞	
ぶびぃ	Magby	固有名詞	
みるたんく	Miltank	固有名詞	
はぴなす	Blissey	固有名詞	
らいこう	Raikou	固有名詞	
えんてい	Entei	固有名詞	
すいくん	Suicune	固有名詞	
よーぎらす	Larvitar	固有名詞	
さなぎらす	Pupitar	固有名詞	
ばんぎらす	Tyranitar	固有名詞	
るぎあ	Lugia	固有名詞	
ほうおう	Ho-Oh	固有名詞	
せれびぃ	Celebi	固有名詞	
きもり	Treecko	固有名詞	
じゅぷとる	Grovyle	固有名詞	
じゅかいん	Sceptile	固有名詞	
あちゃも	Torchic	固有名詞	
わかしゃも	Combusken	固有名詞	
ばしゃーも	Blaziken	固有名詞	
みずごろう	Mudkip	固有名詞	
ぬまくろー	Marshtomp	固有名詞	
らぐらーじ	Swampert	固有名詞	
ぽちえな	Poochyena	固有名詞	
ぐらえな	Mightyena	固有名詞	
じぐざぐま	Zigzagoon	固有名詞	
まっすぐま	Linoone	固有名詞	
けむっそ	Wurmple	固有名詞	
からさりす	Silcoon	固有名詞	
あげはんと	Beautifly	固有名詞	
まゆるど	Cascoon	固有名詞	
どくけいる	Dustox	固有名詞	
はすぼー	Lotad	固有名詞	
はすぶれろ	Lombre	固有名詞	
るんぱっぱ	Ludicolo	固有名詞	
たねぼー	Seedot	固有名詞	
このはな	Nuzleaf	固有名詞	
だーてんぐ	Shiftry	固有名詞	
すばめ	Taillow	固有名詞	
おおすばめ	Swellow	固有名詞	
きゃもめ	Wingull	固有名詞	
ぺりっぱー	Pelipper	固有名詞	
らるとす	Ralts	固有名詞	
きるりあ	Kirlia	固有名詞	
さーないと	Gardevoir	固有名詞	
あめたま	Surskit	固有名詞	
あめもーす	Masquerain	固有名詞	
きのここ	Shroomish	固有名詞	
きのがっさ	Breloom	固有名詞	
なまけろ	Slakoth	固有名詞	
やるきもの	Vigoroth	固有名詞	
けっきんぐ	Slaking	固有名詞	
つちにん	Nincada	固有名詞	
てっかにん	Ninjask	固有名詞	
ぬけにん	Shedinja	固有名詞	
ごにょにょ	Whismur	固有名詞	
どごーむ	Loudred	固有名詞	
ばくおんぐ	Exploud	固有名詞	
まくのした	Makuhita	固有名詞	
はりてやま	Hariyama	固有名詞	
るりり	Azurill	固有名詞	
のずぱす	Nosepass	固有名詞	
えねこ	Skitty	固有名詞	
えねころろ	Delcatty	固有名詞	
やみらみ	Sableye	固有名詞	
くちーと	Mawile	固有名詞	
ここどら	Aron	固有名詞	
こどら	Lairon	固有名詞	
ぼすごどら	Aggron	固有名詞	
あさなん	Meditite	固有名詞	
ちゃーれむ	Medicham	固有名詞	
らくらい	Electrike	固有名詞	
らいぼると	Manectric	固有名詞	
ぷらする	Plusle	固有名詞	
まいなん	Minun	固有名詞	
ばるびーと	Volbeat	固有名詞	
いるみーぜ	Illumise	固有名詞	
ろぜりあ	Roselia	固有名詞	
ごくりん	Gulpin	固有名詞	
まるのーむ	Swalot	固有名詞	
きばにあ	Carvanha	固有名詞	
さめはだー	Sharpedo	固有名詞	
ほえるこ	Wailmer	固有名詞	
ほえるおー	Wailord	固有名詞	
どんめる	Numel	固有名詞	
ばくーだ	Camerupt	固有名詞	
こーたす	Torkoal	固有名詞	
ばねぶー	Spoink	固有名詞	
ぶーぴっぐ	Grumpig	固有名詞	
ぱっちーる	Spinda	固有名詞	
なっくらー	Trapinch	固有名詞	
びぶらーば	Vibrava	固有名詞	
ふらいごん	Flygon	固有名詞	
さぼねあ	Cacnea	固有名詞	
のくたす	Cacturne	固有名詞	
ちるっと	Swablu	固有名詞	
ちるたりす	Altaria	固有名詞	
ざんぐーす	Zangoose	固有名詞	
はぶねーく	Seviper	固有名詞	
るなとーん	Lunatone	固有名詞	
そるろっく	Solrock	固有名詞	
どじょっち	Barboach	固有名詞	
なまずん	Whiscash	固有名詞	
へいがに	Corphish	固有名詞	
しざりがー	Crawdaunt	固有名詞	
やじろん	Baltoy	固有名詞	
ねんどーる	Claydol	固有名詞	
りりーら	Lileep	固有名詞	
ゆれいどる	Cradily	固有名詞	
あのぷす	Anorith	固有名詞	
あーまるど	Armaldo	固有名詞	
ひんばす	Feebas	固有名詞	
みろかろす	Milotic	固有名詞	
ぽわるん	Castform	固有名詞	
かくれおん	Kecleon	固有名詞	
かげぼうず	Shuppet	固有名詞	
じゅぺった	Banette	固有名詞	
よまわる	Duskull	固有名詞	
さまよーる	Dusclops	固有名詞	
とろぴうす	Tropius	固有名詞	
ちりーん	Chimecho	固有名詞	
あぶそる	Absol	固有名詞	
そーなの	Wynaut	固有名詞	
ゆきわらし	Snorunt	固有名詞	
おにごーり	Glalie	固有名詞	
たまざらし	Spheal	固有名詞	
とどぐらー	Sealeo	固有名詞	
とどぜるが	Walrein	固有名詞	
ぱーるる	Clamperl	固有名詞	
はんてーる	Huntail	固有名詞	
さくらびす	Gorebyss	固有名詞	
じーらんす	Relicanth	固有名詞	
らぶかす	Luvdisc	固有名詞	
たつべい	Bagon	固有名詞	
こもるー	Shelgon	固有名詞	
ぼーまんだ	Salamence	固有名詞	
だんばる	Beldum	固有名詞	
めたんぐ	Metang	固有名詞	
めたぐろす	Metagross	固有名詞	
れじろっく	Regirock	固有名詞	
れじあいす	Regice	固有名詞	
れじすちる	Registeel	固有名詞	
らてぃあす	Latias	固有名詞	
らてぃおす	Latios	固有名詞	
かいおーが	Kyogre	固有名詞	
ぐらーどん	Groudon	固有名詞	
れっくうざ	Rayquaza	固有名詞	
じらーち	Jirachi	固有名詞	
でおきしす	Deoxys	固有名詞	
なえとる	Turtwig	固有名詞	
はやしがめ	Grotle	固有名詞	
どだいとす	Torterra	固有名詞	
ひこざる	Chimchar	固有名詞	
もうかざる	Monferno	固有名詞	
ごうかざる	Infernape	固有名詞	
ぽっちゃま	Piplup	固有名詞	
ぽったいし	Prinplup	固有名詞	
えんぺると	Empoleon	固有名詞	
むっくる	Starly	固有名詞	
むくばーど	Staravia	固有名詞	
むくほーく	Staraptor	固有名詞	
びっぱ	Bidoof	固有名詞	
びーだる	Bibarel	固有名詞	
ころぼーし	Kricketot	固有名詞	
ころとっく	Kricketune	固有名詞	
こりんく	Shinx	固有名詞	
るくしお	Luxio	固有名詞	
れんとらー	Luxray	固有名詞	
すぼみー	Budew	固有名詞	
ろずれいど	Roserade	固有名詞	
ずがいどす	Cranidos	固有名詞	
らむぱるど	Rampardos	固有名詞	
たてとぷす	Shieldon	固有名詞	
とりでぷす	Bastiodon	固有名詞	
みのむっち	Burmy	固有名詞	
みのまだむ	Wormadam	固有名詞	
がーめいる	Mothim	固有名詞	
みつはにー	Combee	固有名詞	
びーくいん	Vespiquen	固有名詞	
ぱちりす	Pachirisu	固有名詞	
ぶいぜる	Buizel	固有名詞	
ふろーぜる	Floatzel	固有名詞	
ちぇりんぼ	Cherubi	固有名詞	
ちぇりむ	Cherrim	固有名詞	
からなくし	Shellos	固有名詞	
とりとどん	Gastrodon	固有名詞	
えてぼーす	Ambipom	固有名詞	
ふわんて	Drifloon	固有名詞	
ふわらいど	Drifblim	固有名詞	
みみろる	Buneary	固有名詞	
みみろっぷ	Lopunny	固有名詞	
むうまーじ	Mismagius	固有名詞	
どんからす	Honchkrow	固有名詞	
にゃるまー	Glameow	固有名詞	
ぶにゃっと	Purugly	固有名詞	
りーしゃん	Chingling	固有名詞	
すかんぷー	Stunky	固有名詞	
すかたんく	Skuntank	固有名詞	
どーみらー	Bronzor	固有名詞	
どーたくん	Bronzong	固有名詞	
うそはち	Bonsly	固有名詞	
まねね	Mime Jr.	固有名詞	
ぴんぷく	Happiny	固有名詞	
ぺらっぷ	Chatot	固有名詞	
みかるげ	Spiritomb	固有名詞	
ふかまる	Gible	固有名詞	
がばいと	Gabite	固有名詞	
がぶりあす	Garchomp	固有名詞	
ごんべ	Munchlax	固有名詞	
りおる	Riolu	固有名詞	
るかりお	Lucario	固有名詞	
ひぽぽたす	Hippopotas	固有名詞	
かばるどん	Hippowdon	固有名詞	
すこるぴ	Skorupi	固有名詞	
どらぴおん	Drapion	固有名詞	
ぐれっぐる	Croagunk	固有名詞	
どくろっぐ	Toxicroak	固有名詞	
ますきっぱ	Carnivine	固有名詞	
けいこうお	Finneon	固有名詞	
ねおらんと	Lumineon	固有名詞	
たまんた	Mantyke	固有名詞	
ゆきかぶり	Snover	固有名詞	
ゆきのおー	Abomasnow	固有名詞	
まにゅーら	Weavile	固有名詞	
じばこいる	Magnezone	固有名詞	
べろべると	Lickilicky	固有名詞	
どさいどん	Rhyperior	固有名詞	
もじゃんぼ	Tangrowth	固有名詞	
えれきぶる	Electivire	固有名詞	
ぶーばーん	Magmortar	固有名詞	
とげきっす	Togekiss	固有名詞	
めがやんま	Yanmega	固有名詞	
りーふぃあ	Leafeon	固有名詞	
ぐれいしあ	Glaceon	固有名詞	
ぐらいおん	Gliscor	固有名詞	
まんむー	Mamoswine	固有名詞	
ぽりごんZ	Porygon-Z	固有名詞	
えるれいど	Gallade	固有名詞	
だいのーず	Probopass	固有名詞	
よのわーる	Dusknoir	固有名詞	
ゆきめのこ	Froslass	固有名詞	
ろとむ	Rotom	固有名詞	
ゆくしー	Uxie	固有名詞	
えむりっと	Mesprit	固有名詞	
あぐのむ	Azelf	固有名詞	
でぃあるが	Dialga	固有名詞	
ぱるきあ	Palkia	固有名詞	
ひーどらん	Heatran	固有名詞	
れじぎがす	Regigigas	固有名詞	
ぎらてぃな	Giratina	固有名詞	
くれせりあ	Cresselia	固有名詞	
ふぃおね	Phione	固有名詞	
まなふぃ	Manaphy	固有名詞	
だーくらい	Darkrai	固有名詞	
しぇいみ	Shaymin	固有名詞	
あるせうす	Arceus	固有名詞	
びくてぃに	Victini	固有名詞	
つたーじゃ	Snivy	固有名詞	
じゃのびー	Servine	固有名詞	
じゃろーだ	Serperior	固有名詞	
ぽかぶ	Tepig	固有名詞	
ちゃおぶー	Pignite	固有名詞	
えんぶおー	Emboar	固有名詞	
みじゅまる	Oshawott	固有名詞	
ふたちまる	Dewott	固有名詞	
だいけんき	Samurott	固有名詞	
みねずみ	Patrat	固有名詞	
みるほっぐ	Watchog	固有名詞	
よーてりー	Lillipup	固有名詞	
はーでりあ	Herdier	固有名詞	
むーらんど	Stoutland	固有名詞	
ちょろねこ	Purrloin	固有名詞	
れぱるだす	Liepard	固有名詞	
やなっぷ	Pansage	固有名詞	
やなっきー	Simisage	固有名詞	
ばおっぷ	Pansear	固有名詞	
ばおっきー	Simisear	固有名詞	
ひやっぷ	Panpour	固有名詞	
ひやっきー	Simipour	固有名詞	
むんな	Munna	固有名詞	
むしゃーな	Musharna	固有名詞	
まめぱと	Pidove	固有名詞	
はとーぼー	Tranquill	固有名詞	
けんほろう	Unfezant	固有名詞	
しまま	Blitzle	固有名詞	
ぜぶらいか	Zebstrika	固有名詞	
だんごろ	Roggenrola	固有名詞	
がんとる	Boldore	固有名詞	
ぎがいあす	Gigalith	固有名詞	
ころもり	Woobat	固有名詞	
こころもり	Swoobat	固有名詞	
もぐりゅー	Drilbur	固有名詞	
どりゅうず	Excadrill	固有名詞	
たぶんね	Audino	固有名詞	
どっこらー	Timburr	固有名詞	
どてっこつ	Gurdurr	固有名詞	
ろーぶしん	Conkeldurr	固有名詞	
おたまろ	Tympole	固有名詞	
がまがる	Palpitoad	固有名詞	
がまげろげ	Seismitoad	固有名詞	
なげき	Throh	固有名詞	
だげき	Sawk	固有名詞	
くるみる	Sewaddle	固有名詞	
くるまゆ	Swadloon	固有名詞	
ははこもり	Leavanny	固有名詞	
ふしで	Venipede	固有名詞	
ほいーが	Whirlipede	固有名詞	
ぺんどらー	Scolipede	固有名詞	
もんめん	Cottonee	固有名詞	
えるふーん	Whimsicott	固有名詞	
ちゅりね	Petilil	固有名詞	
どれでぃあ	Lilligant	固有名詞	
ばすらお	Basculin	固有名詞	
めぐろこ	Sandile	固有名詞	
わるびる	Krokorok	固有名詞	
わるびある	Krookodile	固有名詞	
だるまっか	Darumaka	固有名詞	
ひひだるま	Darmanitan	固有名詞	
まらかっち	Maractus	固有名詞	
いしずまい	Dwebble	固有名詞	
いわぱれす	Crustle	固有名詞	
ずるっぐ	Scraggy	固有名詞	
ずるずきん	Scrafty	固有名詞	
しんぼらー	Sigilyph	固有名詞	
ですます	Yamask	固有名詞	
ですかーん	Cofagrigus	固有名詞	
ぷろとーが	Tirtouga	固有名詞	
あばごーら	Carracosta	固有名詞	
あーけん	Archen	固有名詞	
あーけおす	Archeops	固有名詞	
やぶくろん	Trubbish	固有名詞	
だすとだす	Garbodor	固有名詞	
ぞろあ	Zorua	固有名詞	
ぞろあーく	Zoroark	固有名詞	
ちらーみぃ	Minccino	固有名詞	
ちらちーの	Cinccino	固有名詞	
ごちむ	Gothita	固有名詞	
ごちみる	Gothorita	固有名詞	
ごちるぜる	Gothitelle	固有名詞	
ゆにらん	Solosis	固有名詞	
だぶらん	Duosion	固有名詞	
らんくるす	Reuniclus	固有名詞	
こあるひー	Ducklett	固有名詞	
すわんな	Swanna	固有名詞	
ばにぷっち	Vanillite	固有名詞	
ばにりっち	Vanillish	固有名詞	
ばいばにら	Vanilluxe	固有名詞	
しきじか	Deerling	固有名詞	
めぶきじか	Sawsbuck	固有名詞	
えもんが	Emolga	固有名詞	
かぶるも	Karrablast	固有名詞	
しゅばるご	Escavalier	固有名詞	
たまげたけ	Foongus	固有名詞	
もろばれる	Amoonguss	固有名詞	
ぷるりる	Frillish	固有名詞	
ぶるんげる	Jellicent	固有名詞	
ままんぼう	Alomomola	固有名詞	
ばちゅる	Joltik	固有名詞	
でんちゅら	Galvantula	固有名詞	
てっしーど	Ferroseed	固有名詞	
なっとれい	Ferrothorn	固有名詞	
ぎある	Klink	固有名詞	
ぎぎある	Klang	固有名詞	
ぎぎぎある	Klinklang	固有名詞	
しびしらす	Tynamo	固有名詞	
しびびーる	Eelektrik	固有名詞	
しびるどん	Eelektross	固有名詞	
りぐれー	Elgyem	固有名詞	
おーべむ	Beheeyem	固有名詞	
ひともし	Litwick	固有名詞	
らんぷらー	Lampent	固有名詞	
しゃんでら	Chandelure	固有名詞	
きばご	Axew	固有名詞	
おのんど	Fraxure	固有名詞	
おののくす	Haxorus	固有名詞	
くましゅん	Cubchoo	固有名詞	
つんべあー	Beartic	固有名詞	
ふりーじお	Cryogonal	固有名詞	
ちょぼまき	Shelmet	固有名詞	
あぎるだー	Accelgor	固有名詞	
まっぎょ	Stunfisk	固有名詞	
こじょふー	Mienfoo	固有名詞	
こじょんど	Mienshao	固有名詞	
くりむがん	Druddigon	固有名詞	
ごびっと	Golett	固有名詞	
ごるーぐ	Golurk	固有名詞	
こまたな	Pawniard	固有名詞	
きりきざん	Bisharp	固有名詞	
ばっふろん	Bouffalant	固有名詞	
わしぼん	Rufflet	固有名詞	
うぉーぐる	Braviary	固有名詞	
ばるちゃい	Vullaby	固有名詞	
ばるじーな	Mandibuzz	固有名詞	
くいたらん	Heatmor	固有名詞	
あいあんと	Durant	固有名詞	
ものず	Deino	固有名詞	
じへっど	Zweilous	固有名詞	
さざんどら	Hydreigon	固有名詞	
めらるば	Larvesta	固有名詞	
うるがもす	Volcarona	固有名詞	
こばるおん	Cobalion	固有名詞	
てらきおん	Terrakion	固有名詞	
びりじおん	Virizion	固有名詞	
とるねろす	Tornadus	固有名詞	
ぼるとろす	Thundurus	固有名詞	
れしらむ	Reshiram	固有名詞	
ぜくろむ	Zekrom	固有名詞	
らんどろす	Landorus	固有名詞	
きゅれむ	Kyurem	固有名詞	
けるでぃお	Keldeo	固有名詞	
めろえった	Meloetta	固有名詞	
げのせくと	Genesect	固有名詞	
はりまろん	Chespin	固有名詞	
はりぼーぐ	Quilladin	固有名詞	
ぶりがろん	Chesnaught	固有名詞	
ふぉっこ	Fennekin	固有名詞	
てーるなー	Braixen	固有名詞	
まふぉくしー	Delphox	固有名詞	
けろまつ	Froakie	固有名詞	
げこがしら	Frogadier	固有名詞	
げっこうが	Greninja	固有名詞	
ほるびー	Bunnelby	固有名詞	
ほるーど	Diggersby	固有名詞	
ややこま	Fletchling	固有名詞	
ひのやこま	Fletchinder	固有名詞	
ふぁいあろー	Talonflame	固有名詞	
こふきむし	Scatterbug	固有名詞	
こふーらい	Spewpa	固有名詞	
びびよん	Vivillon	固有名詞	
ししこ	Litleo	固有名詞	
かえんじし	Pyroar	固有名詞	
ふらべべ	Flabébé	固有名詞	
ふらえって	Floette	固有名詞	
ふらーじぇす	Florges	固有名詞	
めぇーくる	Skiddo	固有名詞	
ごーごーと	Gogoat	固有名詞	
やんちゃむ	Pancham	固有名詞	
ごろんだ	Pangoro	固有名詞	
とりみあん	Furfrou	固有名詞	
にゃすぱー	Espurr	固有名詞	
にゃおにくす	Meowstic	固有名詞	
ひとつき	Honedge	固有名詞	
にだんぎる	Doublade	固有名詞	
ぎるがるど	Aegislash	固有名詞	
しゅしゅぷ	Spritzee	固有名詞	
ふれふわん	Aromatisse	固有名詞	
ぺろっぱふ	Swirlix	固有名詞	
ぺろりーむ	Slurpuff	固有名詞	
まーいーか	Inkay	固有名詞	
からまねろ	Malamar	固有名詞	
かめてて	Binacle	固有名詞	
がめのです	Barbaracle	固有名詞	
くずもー	Skrelp	固有名詞	
どらみどろ	Dragalge	固有名詞	
うでっぽう	Clauncher	固有名詞	
ぶろすたー	Clawitzer	固有名詞	
えりきてる	Helioptile	固有名詞	
えれざーど	Heliolisk	固有名詞	
ちごらす	Tyrunt	固有名詞	
がちごらす	Tyrantrum	固有名詞	
あまるす	Amaura	固有名詞	
あまるるが	Aurorus	固有名詞	
にんふぃあ	Sylveon	固有名詞	
るちゃぶる	Hawlucha	固有名詞	
ででんね	Dedenne	固有名詞	
めれしー	Carbink	固有名詞	
ぬめら	Goomy	固有名詞	
ぬめいる	Sliggoo	固有名詞	
ぬめるごん	Goodra	固有名詞	
くれっふぃ	Klefki	固有名詞	
ぼくれー	Phantump	固有名詞	
おーろっと	Trevenant	固有名詞	
ばけっちゃ	Pumpkaboo	固有名詞	
ぱんぷじん	Gourgeist	固有名詞	
かちこーる	Bergmite	固有名詞	
くれべーす	Avalugg	固有名詞	
おんばっと	Noibat	固有名詞	
おんばーん	Noivern	固有名詞	
ぜるねあす	Xerneas	固有名詞	
いべるたる	Yveltal	固有名詞	
じがるで	Zygarde	固有名詞	
でぃあんしー	Diancie	固有名詞	
ふーぱ	Hoopa	固有名詞	
ぼるけにおん	Volcanion	固有名詞	
もくろー	Rowlet	固有名詞	
ふくすろー	Dartrix	固有名詞	
じゅないぱー	Decidueye	固有名詞	
にゃびー	Litten	固有名詞	
にゃひーと	Torracat	固有名詞	
がおがえん	Incineroar	固有名詞	
あしまり	Popplio	固有名詞	
おしゃまり	Brionne	固有名詞	
あしれーぬ	Primarina	固有名詞	
つつけら	Pikipek	固有名詞	
けららっぱ	Trumbeak	固有名詞	
どでかばし	Toucannon	固有名詞	
やんぐーす	Yungoos	固有名詞	
でかぐーす	Gumshoos	固有名詞	
あごじむし	Grubbin	固有名詞	
でんぢむし	Charjabug	固有名詞	
くわがのん	Vikavolt	固有名詞	
まけんかに	Crabrawler	固有名詞	
けけんかに	Crabominable	固有名詞	
おどりどり	Oricorio	固有名詞	
あぶりー	Cutiefly	固有名詞	
あぶりぼん	Ribombee	固有名詞	
いわんこ	Rockruff	固有名詞	
るがるがん	Lycanroc	固有名詞	
よわし	Wishiwashi	固有名詞	
ひどいで	Mareanie	固有名詞	
どひどいで	Toxapex	固有名詞	
どろばんこ	Mudbray	固有名詞	
ばんばどろ	Mudsdale	固有名詞	
しずくも	Dewpider	固有名詞	
おにしずくも	Araquanid	固有名詞	
かりきり	Fomantis	固有名詞	
ららんてす	Lurantis	固有名詞	
ねましゅ	Morelull	固有名詞	
ましぇーど	Shiinotic	固有名詞	
やとうもり	Salandit	固有名詞	
えんにゅーと	Salazzle	固有名詞	
ぬいこぐま	Stufful	固有名詞	
きてるぐま	Bewear	固有名詞	
あまかじ	Bounsweet	固有名詞	
あままいこ	Steenee	固有名詞	
あまーじょ	Tsareena	固有名詞	
きゅわわー	Comfey	固有名詞	
やれゆーたん	Oranguru	固有名詞	
なげつけさる	Passimian	固有名詞	
こそくむし	Wimpod	固有名詞	
ぐそくむしゃ	Golisopod	固有名詞	
すなばぁ	Sandygast	固有名詞	
しろですな	Palossand	固有名詞	
なまこぶし	Pyukumuku	固有名詞	
たいぷ:ぬる	Type: Null	固有名詞	
しるゔぁでぃ	Silvally	固有名詞	
めての	Minior	固有名詞	
ねっこあら	Komala	固有名詞	
ばくがめす	Turtonator	固有名詞	
とげでまる	Togedemaru	固有名詞	
みみっきゅ	Mimikyu	固有名詞	
はぎぎしり	Bruxish	固有名詞	
じじーろん	Drampa	固有名詞	
だだりん	Dhelmise	固有名詞	
じゃらこ	Jangmo-o	固有名詞	
じゃらんご	Hakamo-o	固有名詞	
じゃららんが	Kommo-o	固有名詞	
かぷ・こけこ	Tapu Koko	固有名詞	
かぷ・ててふ	Tapu Lele	固有名詞	
かぷ・ぶるる	Tapu Bulu	固有名詞	
かぷ・れひれ	Tapu Fini	固有名詞	
こすもっぐ	Cosmog	固有名詞	
こすもうむ	Cosmoem	固有名詞	
そるがれお	Solgaleo	固有名詞	
るなあーら	Lunala	固有名詞	
うつろいど	Nihilego	固有名詞	
まっしぶーん	Buzzwole	固有名詞	
ふぇろーちぇ	Pheromosa	固有名詞	
でんじゅもく	Xurkitree	固有名詞	
てっかぐや	Celesteela	固有名詞	
かみつるぎ	Kartana	固有名詞	
あくじきんぐ	Guzzlord	固有名詞	
ねくろずま	Necrozma	固有名詞	
まぎあな	Magearna	固有名詞	
まーしゃどー	Marshadow	固有名詞	
べべのむ	Poipole	固有名詞	
あーごよん	Naganadel	固有名詞	
つんでつんで	Stakataka	固有名詞	
ずがどーん	Blacephalon	固有名詞	
ぜらおら	Zeraora	固有名詞	
めるたん	Meltan	固有名詞	
めるめたる	Melmetal	固有名詞	
さるのり	Grookey	固有名詞	
ばちんきー	Thwackey	固有名詞	
ごりらんだー	Rillaboom	固有名詞	
ひばにー	Scorbunny	固有名詞	
らびふっと	Raboot	固有名詞	
えーすばーん	Cinderace	固有名詞	
めっそん	Sobble	固有名詞	
じめれおん	Drizzile	固有名詞	
いんてれおん	Inteleon	固有名詞	
ほしがりす	Skwovet	固有名詞	
よくばりす	Greedent	固有名詞	
ここがら	Rookidee	固有名詞	
あおがらす	Corvisquire	固有名詞	
あーまーがあ	Corviknight	固有名詞	
さっちむし	Blipbug	固有名詞	
れどーむし	Dottler	固有名詞	
いおるぶ	Orbeetle	固有名詞	
くすね	Nickit	固有名詞	
ふぉくすらい	Thievul	固有名詞	
ひめんか	Gossifleur	固有名詞	
わたしらが	Eldegoss	固有名詞	
うーるー	Wooloo	固有名詞	
ばいうーるー	Dubwool	固有名詞	
かむかめ	Chewtle	固有名詞	
かじりがめ	Drednaw	固有名詞	
わんぱち	Yamper	固有名詞	
ぱるすわん	Boltund	固有名詞	
たんどん	Rolycoly	固有名詞	
とろっごん	Carkol	固有名詞	
せきたんざん	Coalossal	固有名詞	
かじっちゅ	Applin	固有名詞	
あっぷりゅー	Flapple	固有名詞	
たるっぷる	Appletun	固有名詞	
すなへび	Silicobra	固有名詞	
さだいじゃ	Sandaconda	固有名詞	
うっう	Cramorant	固有名詞	
さしかます	Arrokuda	固有名詞	
かますじょー	Barraskewda	固有名詞	
えれずん	Toxel	固有名詞	
すとりんだー	Toxtricity	固有名詞	
やくで	Sizzlipede	固有名詞	
まるやくで	Centiskorch	固有名詞	
たたっこ	Clobbopus	固有名詞	
おとすぱす	Grapploct	固有名詞	
やばちゃ	Sinistea	固有名詞	
ぽっとです	Polteageist	固有名詞	
みぶりむ	Hatenna	固有名詞	
てぶりむ	Hattrem	固有名詞	
ぶりむおん	Hatterene	固有名詞	
べろばー	Impidimp	固有名詞	
ぎもー	Morgrem	固有名詞	
おーろんげ	Grimmsnarl	固有名詞	
たちふさぐま	Obstagoon	固有名詞	
にゃいきんぐ	Perrserker	固有名詞	
さにごーん	Cursola	固有名詞	
ねぎがないと	Sirfetch'd	固有名詞	
ばりこおる	Mr. Rime	固有名詞	
ですばーん	Runerigus	固有名詞	
まほみる	Milcery	固有名詞	
まほいっぷ	Alcremie	固有名詞	
たいれーつ	Falinks	固有名詞	
ばちんうに	Pincurchin	固有名詞	
ゆきはみ	Snom	固有名詞	
もすのう	Frosmoth	固有名詞	
いしへんじん	Stonjourner	固有名詞	
こおりっぽ	Eiscue	固有名詞	
いえっさん	Indeedee	固有名詞	
もるぺこ	Morpeko	固有名詞	
ぞうどう	Cufant	固有名詞	
だいおうどう	Copperajah	固有名詞	
ぱっちらごん	Dracozolt	固有名詞	
ぱっちるどん	Arctozolt	固有名詞	
うおのらごん	Dracovish	固有名詞	
うおちるどん	Arctovish	固有名詞	
じゅらるどん	Duraludon	固有名詞	
どらめしや	Dreepy	固有名詞	
どろんち	Drakloak	固有名詞	
どらぱると	Dragapult	固有名詞	
ざしあん	Zacian	固有名詞	
ざまぜんた	Zamazenta	固有名詞	
むげんだいな	Eternatus	固有名詞	
だくま	Kubfu	固有名詞	
うーらおす	Urshifu	固有名詞	
ざるーど	Zarude	固有名詞	
れじえれき	Regieleki	固有名詞	
れじどらご	Regidrago	固有名詞	
ぶりざぽす	Glastrier	固有名詞	
れいすぽす	Spectrier	固有名詞	
ばどれっくす	Calyrex	固有名詞	
あやしし	Wyrdeer	固有名詞	
ばさぎり	Kleavor	固有名詞	
がちぐま	Ursaluna	固有名詞	
いだいとう	Basculegion	固有名詞	
おおにゅーら	Sneasler	固有名詞	
はりーまん	Overqwil	固有名詞	
らぶとろす	Enamorus	固有名詞	
にゃおは	Sprigatito	固有名詞	
にゃろーて	Floragato	固有名詞	
ますかーにゃ	Meowscarada	固有名詞	
ほげーた	Fuecoco	固有名詞	
あちげーた	Crocalor	固有名詞	
らうどぼーん	Skeledirge	固有名詞	
くわっす	Quaxly	固有名詞	
うぇるかも	Quaxwell	固有名詞	
うぇーにばる	Quaquaval	固有名詞	
ぐるとん	Lechonk	固有名詞	
ぱふゅーとん	Oinkologne	固有名詞	
たまんちゅら	Tarountula	固有名詞	
わないだー	Spidops	固有名詞	
まめばった	Nymble	固有名詞	
えくすれっぐ	Lokix	固有名詞	
ぱも	Pawmi	固有名詞	
ぱもっと	Pawmo	固有名詞	
ぱーもっと	Pawmot	固有名詞	
わっかねずみ	Tandemaus	固有名詞	
いっかねずみ	Maushold	固有名詞	
ぱぴもっち	Fidough	固有名詞	
ばうっつぇる	Dachsbun	固有名詞	
みにーぶ	Smoliv	固有名詞	
おりーにょ	Dolliv	固有名詞	
おりーゔぁ	Arboliva	固有名詞	
いきりんこ	Squawkabilly	固有名詞	
こじお	Nacli	固有名詞	
じおづむ	Naclstack	固有名詞	
きょじおーん	Garganacl	固有名詞	
かるぼう	Charcadet	固有名詞	
ぐれんあるま	Armarouge	固有名詞	
そうぶれいず	Ceruledge	固有名詞	
ずぴか	Tadbulb	固有名詞	
はらばりー	Bellibolt	固有名詞	
かいでん	Wattrel	固有名詞	
たいかいでん	Kilowattrel	固有名詞	
おらちふ	Maschiff	固有名詞	
まふぃてぃふ	Mabosstiff	固有名詞	
しるしゅるー	Shroodle	固有名詞	
たぎんぐる	Grafaiai	固有名詞	
あのくさ	Bramblin	固有名詞	
あのほらぐさ	Brambleghast	固有名詞	
ののくらげ	Toedscool	固有名詞	
りくくらげ	Toedscruel	固有名詞	
がけがに	Klawf	固有名詞	
かぷさいじ	Capsakid	固有名詞	
すこゔぃらん	Scovillain	固有名詞	
しがろこ	Rellor	固有名詞	
べらかす	Rabsca	固有名詞	
ひらひな	Flittle	固有名詞	
くえすぱとら	Espathra	固有名詞	
かぬちゃん	Tinkatink	固有名詞	
なかぬちゃん	Tinkatuff	固有名詞	
でかぬちゃん	Tinkaton	固有名詞	
うみでぃぐだ	Wiglett	固有名詞	
うみとりお	Wugtrio	固有名詞	
おとしどり	Bombirdier	固有名詞	
なみいるか	Finizen	固有名詞	
いるかまん	Palafin	固有名詞	
ぶろろん	Varoom	固有名詞	
ぶろろろーむ	Revavroom	固有名詞	
もととかげ	Cyclizar	固有名詞	
みみずず	Orthworm	固有名詞	
きらーめ	Glimmet	固有名詞	
きらふろる	Glimmora	固有名詞	
ぼち	Greavard	固有名詞	
はかどっぐ	Houndstone	固有名詞	
からみんご	Flamigo	固有名詞	
あるくじら	Cetoddle	固有名詞	
はるくじら	Cetitan	固有名詞	
みがるーさ	Veluza	固有名詞	
へいらっしゃ	Dondozo	固有名詞	
しゃりたつ	Tatsugiri	固有名詞	
このよざる	Annihilape	固有名詞	
どおー	Clodsire	固有名詞	
りききりん	Farigiraf	固有名詞	
のここっち	Dudunsparce	固有名詞	
どどげざん	Kingambit	固有名詞	
いだいなきば	Great Tusk	固有名詞	
さけぶしっぽ	Scream Tail	固有名詞	
あらぶるたけ	Brute Bonnet	固有名詞	
はばたくかみ	Flutter Mane	固有名詞	
ちをはうはね	Slither Wing	固有名詞	
すなのけがわ	Sandy Shocks	固有名詞	
てつのわだち	Iron Treads	固有名詞	
てつのつつみ	Iron Bundle	固有名詞	
てつのかいな	Iron Hands	固有名詞	
てつのこうべ	Iron Jugulis	固有名詞	
てつのどくが	Iron Moth	固有名詞	
てつのいばら	Iron Thorns	固有名詞	
せびえ	Frigibax	固有名詞	
せごーる	Arctibax	固有名詞	
せぐれいぶ	Baxcalibur	固有名詞	
これくれー	Gimmighoul	固有名詞	
さーふごー	Gholdengo	固有名詞	
ちおんじぇん	Wo-Chien	固有名詞	
ぱおじあん	Chien-Pao	固有名詞	
でぃんるー	Ting-Lu	固有名詞	
いーゆい	Chi-Yu	固有名詞	
とどろくつき	Roaring Moon	固有名詞	
てつのぶじん	Iron Valiant	固有名詞	
こらいどん	Koraidon	固有名詞	
みらいどん	Miraidon	固有名詞	
うねるみなも	Walking Wake	固有名詞	
てつのいさは	Iron Leaves	固有名詞	
かみっちゅ	Dipplin	固有名詞	
ちゃです	Poltchageist	固有名詞	
やばそちゃ	Sinistcha	固有名詞	
いいねいぬ	Okidogi	固有名詞	
ましましら	Munkidori	固有名詞	
きちきぎす	Fezandipiti	固有名詞	
おーがぽん	Ogerpon	固有名詞	
ぶりじゅらす	Archaludon	固有名詞	
かみつおろち	Hydrapple	固有名詞	
うがつほむら	Gouging Fire	固有名詞	
たけるらいこ	Raging Bolt	固有名詞	
てつのいわお	Iron Boulder	固有名詞	
てつのかしら	Iron Crown	固有名詞	
てらぱごす	Terapagos	固有名詞	
ももわろう	Pecharunt	固有名詞	
