ふしぎだね	フシギダネ	固有名詞	
ふしぎそう	フシギソウ	固有名詞	
ふしぎばな	フシギバナ	固有名詞	
ひとかげ	ヒトカゲ	固有名詞	
りざーど	リザード	固有名詞	
りざーどん	リザードン	固有名詞	
ぜにがめ	ゼニガメ	固有名詞	
かめーる	カメール	固有名詞	
かめっくす	カメックス	固有名詞	
きゃたぴー	キャタピー	固有名詞	
とらんせる	トランセル	固有名詞	
ばたふりー	バタフリー	固有名詞	
びーどる	ビードル	固有名詞	
こくーん	コクーン	固有名詞	
すぴあー	スピアー	固有名詞	
ぽっぽ	ポッポ	固有名詞	
ぴじょん	ピジョン	固有名詞	
ぴじょっと	ピジョット	固有名詞	
こらった	コラッタ	固有名詞	
らった	ラッタ	固有名詞	
おにすずめ	オニスズメ	固有名詞	
おにどりる	オニドリル	固有名詞	
あーぼ	アーボ	固有名詞	
あーぼっく	アーボック	固有名詞	
ぴかちゅう	ピカチュウ	固有名詞	
らいちゅう	ライチュウ	固有名詞	
さんど	サンド	固有名詞	
さんどぱん	サンドパン	固有名詞	
にどらん♀	ニドラン♀	固有名詞	
にどりーな	ニドリーナ	固有名詞	
にどくいん	ニドクイン	固有名詞	
にどらん♂	ニドラン♂	固有名詞	
にどりーの	ニドリーノ	固有名詞	
にどきんぐ	ニドキング	固有名詞	
ぴっぴ	ピッピ	固有名詞	
ぴくしー	ピクシー	固有名詞	
ろこん	ロコン	固有名詞	
きゅうこん	キュウコン	固有名詞	
ぷりん	プリン	固有名詞	
ぷくりん	プクリン	固有名詞	
ずばっと	ズバット	固有名詞	
ごるばっと	ゴルバット	固有名詞	
なぞのくさ	ナゾノクサ	固有名詞	
くさいはな	クサイハナ	固有名詞	
らふれしあ	ラフレシア	固有名詞	
ぱらす	パラス	固有名詞	
ぱらせくと	パラセクト	固有名詞	
こんぱん	コンパン	固有名詞	
もるふぉん	モルフォン	固有名詞	
でぃぐだ	ディグダ	固有名詞	
だぐとりお	ダグトリオ	固有名詞	
にゃーす	ニャース	固有名詞	
ぺるしあん	ペルシアン	固有名詞	
こだっく	コダック	固有名詞	
ごるだっく	ゴルダック	固有名詞	
まんきー	マンキー	固有名詞	
おこりざる	オコリザル	固有名詞	
がーでぃ	ガーディ	固有名詞	
ういんでぃ	ウインディ	固有名詞	
にょろも	ニョロモ	固有名詞	
にょろぞ	ニョロゾ	固有名詞	
にょろぼん	ニョロボン	固有名詞	
けーしぃ	ケーシィ	固有名詞	
ゆんげらー	ユンゲラー	固有名詞	
ふーでぃん	フーディン	固有名詞	
わんりきー	ワンリキー	固有名詞	
ごーりきー	ゴーリキー	固有名詞	
かいりきー	カイリキー	固有名詞	
まだつぼみ	マダツボミ	固有名詞	
うつどん	ウツドン	固有名詞	
うつぼっと	ウツボット	固有名詞	
めのくらげ	メノクラゲ	固有名詞	
どくくらげ	ドククラゲ	固有名詞	
いしつぶて	イシツブテ	固有名詞	
ごろーん	ゴローン	固有名詞	
ごろーにゃ	ゴローニャ	固有名詞	
ぽにーた	ポニータ	固有名詞	
ぎゃろっぷ	ギャロップ	固有名詞	
やどん	ヤドン	固有名詞	
やどらん	ヤドラン	固有名詞	
こいる	コイル	固有名詞	
れあこいる	レアコイル	固有名詞	
かもねぎ	カモネギ	固有名詞	
どーどー	ドードー	固有名詞	
どーどりお	ドードリオ	固有名詞	
ぱうわう	パウワウ	固有名詞	
じゅごん	ジュゴン	固有名詞	
べとべたー	ベトベター	固有名詞	
べとべとん	ベトベトン	固有名詞	
しぇるだー	シェルダー	固有名詞	
ぱるしぇん	パルシェン	固有名詞	
ごーす	ゴース	固有名詞	
ごーすと	ゴースト	固有名詞	
げんがー	ゲンガー	固有名詞	
いわーく	イワーク	固有名詞	
すりーぷ	スリープ	固有名詞	
すりーぱー	スリーパー	固有名詞	
くらぶ	クラブ	固有名詞	
きんぐらー	キングラー	固有名詞	
びりりだま	ビリリダマ	固有名詞	
まるまいん	マルマイン	固有名詞	
たまたま	タマタマ	固有名詞	
なっしー	ナッシー	固有名詞	
からから	カラカラ	固有名詞	
がらがら	ガラガラ	固有名詞	
さわむらー	サワムラー	固有名詞	
えびわらー	エビワラー	固有名詞	
べろりんが	ベロリンガ	固有名詞	
どがーす	ドガース	固有名詞	
またどがす	マタドガス	固有名詞	
さいほーん	サイホーン	固有名詞	
さいどん	サイドン	固有名詞	
らっきー	ラッキー	固有名詞	
もんじゃら	モンジャラ	固有名詞	
がるーら	ガルーラ	固有名詞	
たっつー	タッツー	固有名詞	
しーどら	シードラ	固有名詞	
とさきんと	トサキント	固有名詞	
あずまおう	アズマオウ	固有名詞	
ひとでまん	ヒトデマン	固有名詞	
すたーみー	スターミー	固有名詞	
ばりやーど	バリヤード	固有名詞	
すとらいく	ストライク	固有名詞	
るーじゅら	ルージュラ	固有名詞	
えれぶー	エレブー	固有名詞	
ぶーばー	ブーバー	固有名詞	
かいろす	カイロス	固有名詞	
けんたろす	ケンタロス	固有名詞	
こいきんぐ	コイキング	固有名詞	
ぎゃらどす	ギャラドス	固有名詞	
らぷらす	ラプラス	固有名詞	
めたもん	メタモン	固有名詞	
いーぶい	イーブイ	固有名詞	
しゃわーず	シャワーズ	固有名詞	
さんだーす	サンダース	固有名詞	
ぶーすたー	ブースター	固有名詞	
ぽりごん	ポリゴン	固有名詞	
おむないと	オムナイト	固有名詞	
おむすたー	オムスター	固有名詞	
かぶと	カブト	固有名詞	
かぶとぷす	カブトプス	固有名詞	
ぷてら	プテラ	固有名詞	
かびごん	カビゴン	固有名詞	
ふりーざー	フリーザー	固有名詞	
さんだー	サンダー	固有名詞	
ふぁいやー	ファイヤー	固有名詞	
みにりゅう	ミニリュウ	固有名詞	
はくりゅー	ハクリュー	固有名詞	
かいりゅー	カイリュー	固有名詞	
みゅうつー	ミュウツー	固有名詞	
みゅう	ミュウ	固有名詞	
ちこりーた	チコリータ	固有名詞	
べいりーふ	ベイリーフ	固有名詞	
めがにうむ	メガニウム	固有名詞	
ひのあらし	ヒノアラシ	固有名詞	
まぐまらし	マグマラシ	固有名詞	
ばくふーん	バクフーン	固有名詞	
わにのこ	ワニノコ	固有名詞	
ありげいつ	アリゲイツ	固有名詞	
おーだいる	オーダイル	固有名詞	
おたち	オタチ	固有名詞	
おおたち	オオタチ	固有名詞	
ほーほー	ホーホー	固有名詞	
よるのずく	ヨルノズク	固有名詞	
れでぃば	レディバ	固有名詞	
れでぃあん	レディアン	固有名詞	
いとまる	イトマル	固有名詞	
ありあどす	アリアドス	固有名詞	
くろばっと	クロバット	固有名詞	
ちょんちー	チョンチー	固有名詞	
らんたーん	ランターン	固有名詞	
ぴちゅー	ピチュー	固有名詞	
ぴぃ	ピィ	固有名詞	
ぷぷりん	ププリン	固有名詞	
とげぴー	トゲピー	固有名詞	
とげちっく	トゲチック	固有名詞	
ねいてぃ	ネイティ	固有名詞	
ねいてぃお	ネイティオ	固有名詞	
めりーぷ	メリープ	固有名詞	
もここ	モココ	固有名詞	
でんりゅう	デンリュウ	固有名詞	
きれいはな	キレイハナ	固有名詞	
まりる	マリル	固有名詞	
まりるり	マリルリ	固有名詞	
うそっきー	ウソッキー	固有名詞	
にょろとの	ニョロトノ	固有名詞	
はねっこ	ハネッコ	固有名詞	
ぽぽっこ	ポポッコ	固有名詞	
わたっこ	ワタッコ	固有名詞	
えいぱむ	エイパム	固有名詞	
ひまなっつ	ヒマナッツ	固有名詞	
きまわり	キマワリ	固有名詞	
やんやんま	ヤンヤンマ	固有名詞	
うぱー	ウパー	固有名詞	
ぬおー	ヌオー	固有名詞	
えーふぃ	エーフィ	固有名詞	
ぶらっきー	ブラッキー	固有名詞	
やみからす	ヤミカラス	固有名詞	
やどきんぐ	ヤドキング	固有名詞	
むうま	ムウマ	固有名詞	
あんのーん	アンノーン	固有名詞	
そーなんす	ソーナンス	固有名詞	
きりんりき	キリンリキ	固有名詞	
くぬぎだま	クヌギダマ	固有名詞	
ふぉれとす	フォレトス	固有名詞	
のこっち	ノコッチ	固有名詞	
ぐらいがー	グライガー	固有名詞	
はがねーる	ハガネール	固有名詞	
ぶるー	ブルー	固有名詞	
ぐらんぶる	グランブル	固有名詞	
はりーせん	ハリーセン	固有名詞	
はっさむ	ハッサム	固有名詞	
つぼつぼ	ツボツボ	固有名詞	
へらくろす	ヘラクロス	固有名詞	
にゅーら	ニューラ	固有名詞	
ひめぐま	ヒメグマ	固有名詞	
りんぐま	リングマ	固有名詞	
まぐまっぐ	マグマッグ	固有名詞	
まぐかるご	マグカルゴ	固有名詞	
うりむー	ウリムー	固有名詞	
いのむー	イノムー	固有名詞	
さにーご	サニーゴ	固有名詞	
てっぽうお	テッポウオ	固有名詞	
おくたん	オクタン	固有名詞	
でりばーど	デリバード	固有名詞	
まんたいん	マンタイン	固有名詞	
えあーむど	エアームド	固有名詞	
でるびる	デルビル	固有名詞	
へるがー	ヘルガー	固有名詞	
きんぐどら	キングドラ	固有名詞	
ごまぞう	ゴマゾウ	固有名詞	
どんふぁん	ドンファン	固有名詞	
ぽりごんに	ポリゴン2	固有名詞	
おどしし	オドシシ	固有名詞	
どーぶる	ドーブル	固有名詞	
ばるきー	バルキー	固有名詞	
かぽえらー	カポエラー	固有名詞	
むちゅーる	ムチュール	固有名詞	
えれきっど	エレキッド	固有名詞	
ぶびぃ	ブビィ	固有名詞	
みるたんく	ミルタンク	固有名詞	
はぴなす	ハピナス	固有名詞	
らいこう	ライコウ	固有名詞	
えんてい	エンテイ	固有名詞	
すいくん	スイクン	固有名詞	
よーぎらす	ヨーギラス	固有名詞	
さなぎらす	サナギラス	固有名詞	
ばんぎらす	バンギラス	固有名詞	
るぎあ	ルギア	固有名詞	
ほうおう	ホウオウ	固有名詞	
せれびぃ	セレビィ	固有名詞	
きもり	キモリ	固有名詞	
じゅぷとる	ジュプトル	固有名詞	
じゅかいん	ジュカイン	固有名詞	
あちゃも	アチャモ	固有名詞	
わかしゃも	ワカシャモ	固有名詞	
ばしゃーも	バシャーモ	固有名詞	
みずごろう	ミズゴロウ	固有名詞	
ぬまくろー	ヌマクロー	固有名詞	
らぐらーじ	ラグラージ	固有名詞	
ぽちえな	ポチエナ	固有名詞	
ぐらえな	グラエナ	固有名詞	
じぐざぐま	ジグザグマ	固有名詞	
まっすぐま	マッスグマ	固有名詞	
けむっそ	ケムッソ	固有名詞	
からさりす	カラサリス	固有名詞	
あげはんと	アゲハント	固有名詞	
まゆるど	マユルド	固有名詞	
どくけいる	ドクケイル	固有名詞	
はすぼー	ハスボー	固有名詞	
はすぶれろ	ハスブレロ	固有名詞	
るんぱっぱ	ルンパッパ	固有名詞	
たねぼー	タネボー	固有名詞	
このはな	コノハナ	固有名詞	
だーてんぐ	ダーテング	固有名詞	
すばめ	スバメ	固有名詞	
おおすばめ	オオスバメ	固有名詞	
きゃもめ	キャモメ	固有名詞	
ぺりっぱー	ペリッパー	固有名詞	
らるとす	ラルトス	固有名詞	
きるりあ	キルリア	固有名詞	
さーないと	サーナイト	固有名詞	
あめたま	アメタマ	固有名詞	
あめもーす	アメモース	固有名詞	
きのここ	キノココ	固有名詞	
きのがっさ	キノガッサ	固有名詞	
なまけろ	ナマケロ	固有名詞	
やるきもの	ヤルキモノ	固有名詞	
けっきんぐ	ケッキング	固有名詞	
つちにん	ツチニン	固有名詞	
てっかにん	テッカニン	固有名詞	
ぬけにん	ヌケニン	固有名詞	
ごにょにょ	ゴニョニョ	固有名詞	
どごーむ	ドゴーム	固有名詞	
ばくおんぐ	バクオング	固有名詞	
まくのした	マクノシタ	固有名詞	
はりてやま	ハリテヤマ	固有名詞	
るりり	ルリリ	固有名詞	
のずぱす	ノズパス	固有名詞	
えねこ	エネコ	固有名詞	
えねころろ	エネコロロ	固有名詞	
やみらみ	ヤミラミ	固有名詞	
くちーと	クチート	固有名詞	
ここどら	ココドラ	固有名詞	
こどら	コドラ	固有名詞	
ぼすごどら	ボスゴドラ	固有名詞	
あさなん	アサナン	固有名詞	
ちゃーれむ	チャーレム	固有名詞	
らくらい	ラクライ	固有名詞	
らいぼると	ライボルト	固有名詞	
ぷらする	プラスル	固有名詞	
まいなん	マイナン	固有名詞	
ばるびーと	バルビート	固有名詞	
いるみーぜ	イルミーゼ	固有名詞	
ろぜりあ	ロゼリア	固有名詞	
ごくりん	ゴクリン	固有名詞	
まるのーむ	マルノーム	固有名詞	
きばにあ	キバニア	固有名詞	
さめはだー	サメハダー	固有名詞	
ほえるこ	ホエルコ	固有名詞	
ほえるおー	ホエルオー	固有名詞	
どんめる	ドンメル	固有名詞	
ばくーだ	バクーダ	固有名詞	
こーたす	コータス	固有名詞	
ばねぶー	バネブー	固有名詞	
ぶーぴっぐ	ブーピッグ	固有名詞	
ぱっちーる	パッチール	固有名詞	
なっくらー	ナックラー	固有名詞	
びぶらーば	ビブラーバ	固有名詞	
ふらいごん	フライゴン	固有名詞	
さぼねあ	サボネア	固有名詞	
のくたす	ノクタス	固有名詞	
ちるっと	チルット	固有名詞	
ちるたりす	チルタリス	固有名詞	
ざんぐーす	ザングース	固有名詞	
はぶねーく	ハブネーク	固有名詞	
るなとーん	ルナトーン	固有名詞	
そるろっく	ソルロック	固有名詞	
どじょっち	ドジョッチ	固有名詞	
なまずん	ナマズン	固有名詞	
へいがに	ヘイガニ	固有名詞	
しざりがー	シザリガー	固有名詞	
やじろん	ヤジロン	固有名詞	
ねんどーる	ネンドール	固有名詞	
りりーら	リリーラ	固有名詞	
ゆれいどる	ユレイドル	固有名詞	
あのぷす	アノプス	固有名詞	
あーまるど	アーマルド	固有名詞	
ひんばす	ヒンバス	固有名詞	
みろかろす	ミロカロス	固有名詞	
ぽわるん	ポワルン	固有名詞	
かくれおん	カクレオン	固有名詞	
かげぼうず	カゲボウズ	固有名詞	
じゅぺった	ジュペッタ	固有名詞	
よまわる	ヨマワル	固有名詞	
さまよーる	サマヨール	固有名詞	
とろぴうす	トロピウス	固有名詞	
ちりーん	チリーン	固有名詞	
あぶそる	アブソル	固有名詞	
そーなの	ソーナノ	固有名詞	
ゆきわらし	ユキワラシ	固有名詞	
おにごーり	オニゴーリ	固有名詞	
たまざらし	タマザラシ	固有名詞	
とどぐらー	トドグラー	固有名詞	
とどぜるが	トドゼルガ	固有名詞	
ぱーるる	パールル	固有名詞	
はんてーる	ハンテール	固有名詞	
さくらびす	サクラビス	固有名詞	
じーらんす	ジーランス	固有名詞	
らぶかす	ラブカス	固有名詞	
たつべい	タツベイ	固有名詞	
こもるー	コモルー	固有名詞	
ぼーまんだ	ボーマンダ	固有名詞	
だんばる	ダンバル	固有名詞	
めたんぐ	メタング	固有名詞	
めたぐろす	メタグロス	固有名詞	
れじろっく	レジロック	固有名詞	
れじあいす	レジアイス	固有名詞	
れじすちる	レジスチル	固有名詞	
らてぃあす	ラティアス	固有名詞	
らてぃおす	ラティオス	固有名詞	
かいおーが	カイオーガ	固有名詞	
ぐらーどん	グラードン	固有名詞	
れっくうざ	レックウザ	固有名詞	
じらーち	ジラーチ	固有名詞	
でおきしす	デオキシス	固有名詞	
なえとる	ナエトル	固有名詞	
はやしがめ	ハヤシガメ	固有名詞	
どだいとす	ドダイトス	固有名詞	
ひこざる	ヒコザル	固有名詞	
もうかざる	モウカザル	固有名詞	
ごうかざる	ゴウカザル	固有名詞	
ぽっちゃま	ポッチャマ	固有名詞	
ぽったいし	ポッタイシ	固有名詞	
えんぺると	エンペルト	固有名詞	
むっくる	ムックル	固有名詞	
むくばーど	ムクバード	固有名詞	
むくほーく	ムクホーク	固有名詞	
びっぱ	ビッパ	固有名詞	
びーだる	ビーダル	固有名詞	
ころぼーし	コロボーシ	固有名詞	
ころとっく	コロトック	固有名詞	
こりんく	コリンク	固有名詞	
るくしお	ルクシオ	固有名詞	
れんとらー	レントラー	固有名詞	
すぼみー	スボミー	固有名詞	
ろずれいど	ロズレイド	固有名詞	
ずがいどす	ズガイドス	固有名詞	
らむぱるど	ラムパルド	固有名詞	
たてとぷす	タテトプス	固有名詞	
とりでぷす	トリデプス	固有名詞	
みのむっち	ミノムッチ	固有名詞	
みのまだむ	ミノマダム	固有名詞	
がーめいる	ガーメイル	固有名詞	
みつはにー	ミツハニー	固有名詞	
びーくいん	ビークイン	固有名詞	
ぱちりす	パチリス	固有名詞	
ぶいぜる	ブイゼル	固有名詞	
ふろーぜる	フローゼル	固有名詞	
ちぇりんぼ	チェリンボ	固有名詞	
ちぇりむ	チェリム	固有名詞	
からなくし	カラナクシ	固有名詞	
とりとどん	トリトドン	固有名詞	
えてぼーす	エテボース	固有名詞	
ふわんて	フワンテ	固有名詞	
ふわらいど	フワライド	固有名詞	
みみろる	ミミロル	固有名詞	
みみろっぷ	ミミロップ	固有名詞	
むうまーじ	ムウマージ	固有名詞	
どんからす	ドンカラス	固有名詞	
にゃるまー	ニャルマー	固有名詞	
ぶにゃっと	ブニャット	固有名詞	
りーしゃん	リーシャン	固有名詞	
すかんぷー	スカンプー	固有名詞	
すかたんく	スカタンク	固有名詞	
どーみらー	ドーミラー	固有名詞	
どーたくん	ドータクン	固有名詞	
うそはち	ウソハチ	固有名詞	
まねね	マネネ	固有名詞	
ぴんぷく	ピンプク	固有名詞	
ぺらっぷ	ペラップ	固有名詞	
みかるげ	ミカルゲ	固有名詞	
ふかまる	フカマル	固有名詞	
がばいと	ガバイト	固有名詞	
がぶりあす	ガブリアス	固有名詞	
ごんべ	ゴンベ	固有名詞	
りおる	リオル	固有名詞	
るかりお	ルカリオ	固有名詞	
ひぽぽたす	ヒポポタス	固有名詞	
かばるどん	カバルドン	固有名詞	
すこるぴ	スコルピ	固有名詞	
どらぴおん	ドラピオン	固有名詞	
ぐれっぐる	グレッグル	固有名詞	
どくろっぐ	ドクロッグ	固有名詞	
ますきっぱ	マスキッパ	固有名詞	
けいこうお	ケイコウオ	固有名詞	
ねおらんと	ネオラント	固有名詞	
たまんた	タマンタ	固有名詞	
ゆきかぶり	ユキカブリ	固有名詞	
ゆきのおー	ユキノオー	固有名詞	
まにゅーら	マニューラ	固有名詞	
じばこいる	ジバコイル	固有名詞	
べろべると	ベロベルト	固有名詞	
どさいどん	ドサイドン	固有名詞	
もじゃんぼ	モジャンボ	固有名詞	
えれきぶる	エレキブル	固有名詞	
ぶーばーん	ブーバーン	固有名詞	
とげきっす	トゲキッス	固有名詞	
めがやんま	メガヤンマ	固有名詞	
りーふぃあ	リーフィア	固有名詞	
ぐれいしあ	グレイシア	固有名詞	
ぐらいおん	グライオン	固有名詞	
まんむー	マンムー	固有名詞	
ぽりごんぜっと	ポリゴンZ	固有名詞	
えるれいど	エルレイド	固有名詞	
だいのーず	ダイノーズ	固有名詞	
よのわーる	ヨノワール	固有名詞	
ゆきめのこ	ユキメノコ	固有名詞	
ろとむ	ロトム	固有名詞	
ゆくしー	ユクシー	固有名詞	
えむりっと	エムリット	固有名詞	
あぐのむ	アグノム	固有名詞	
でぃあるが	ディアルガ	固有名詞	
ぱるきあ	パルキア	固有名詞	
ひーどらん	ヒードラン	固有名詞	
れじぎがす	レジギガス	固有名詞	
ぎらてぃな	ギラティナ	固有名詞	
くれせりあ	クレセリア	固有名詞	
ふぃおね	フィオネ	固有名詞	
まなふぃ	マナフィ	固有名詞	
だーくらい	ダークライ	固有名詞	
しぇいみ	シェイミ	固有名詞	
あるせうす	アルセウス	固有名詞	
びくてぃに	ビクティニ	固有名詞	
つたーじゃ	ツタージャ	固有名詞	
じゃのびー	ジャノビー	固有名詞	
じゃろーだ	ジャローダ	固有名詞	
ぽかぶ	ポカブ	固有名詞	
ちゃおぶー	チャオブー	固有名詞	
えんぶおー	エンブオー	固有名詞	
みじゅまる	ミジュマル	固有名詞	
ふたちまる	フタチマル	固有名詞	
だいけんき	ダイケンキ	固有名詞	
みねずみ	ミネズミ	固有名詞	
みるほっぐ	ミルホッグ	固有名詞	
よーてりー	ヨーテリー	固有名詞	
はーでりあ	ハーデリア	固有名詞	
むーらんど	ムーランド	固有名詞	
ちょろねこ	チョロネコ	固有名詞	
れぱるだす	レパルダス	固有名詞	
やなっぷ	ヤナップ	固有名詞	
やなっきー	ヤナッキー	固有名詞	
ばおっぷ	バオップ	固有名詞	
ばおっきー	バオッキー	固有名詞	
ひやっぷ	ヒヤップ	固有名詞	
ひやっきー	ヒヤッキー	固有名詞	
むんな	ムンナ	固有名詞	
むしゃーな	ムシャーナ	固有名詞	
まめぱと	マメパト	固有名詞	
はとーぼー	ハトーボー	固有名詞	
けんほろう	ケンホロウ	固有名詞	
しまま	シママ	固有名詞	
ぜぶらいか	ゼブライカ	固有名詞	
だんごろ	ダンゴロ	固有名詞	
がんとる	ガントル	固有名詞	
ぎがいあす	ギガイアス	固有名詞	
ころもり	コロモリ	固有名詞	
こころもり	ココロモリ	固有名詞	
もぐりゅー	モグリュー	固有名詞	
どりゅうず	ドリュウズ	固有名詞	
たぶんね	タブンネ	固有名詞	
どっこらー	ドッコラー	固有名詞	
どてっこつ	ドテッコツ	固有名詞	
ろーぶしん	ローブシン	固有名詞	
おたまろ	オタマロ	固有名詞	
がまがる	ガマガル	固有名詞	
がまげろげ	ガマゲロゲ	固有名詞	
なげき	ナゲキ	固有名詞	
だげき	ダゲキ	固有名詞	
くるみる	クルミル	固有名詞	
くるまゆ	クルマユ	固有名詞	
ははこもり	ハハコモリ	固有名詞	
ふしで	フシデ	固有名詞	
ほいーが	ホイーガ	固有名詞	
ぺんどらー	ペンドラー	固有名詞	
もんめん	モンメン	固有名詞	
えるふーん	エルフーン	固有名詞	
ちゅりね	チュリネ	固有名詞	
どれでぃあ	ドレディア	固有名詞	
ばすらお	バスラオ	固有名詞	
めぐろこ	メグロコ	固有名詞	
わるびる	ワルビル	固有名詞	
わるびある	ワルビアル	固有名詞	
だるまっか	ダルマッカ	固有名詞	
ひひだるま	ヒヒダルマ	固有名詞	
まらかっち	マラカッチ	固有名詞	
いしずまい	イシズマイ	固有名詞	
いわぱれす	イワパレス	固有名詞	
ずるっぐ	ズルッグ	固有名詞	
ずるずきん	ズルズキン	固有名詞	
しんぼらー	シンボラー	固有名詞	
ですます	デスマス	固有名詞	
ですかーん	デスカーン	固有名詞	
ぷろとーが	プロトーガ	固有名詞	
あばごーら	アバゴーラ	固有名詞	
あーけん	アーケン	固有名詞	
あーけおす	アーケオス	固有名詞	
やぶくろん	ヤブクロン	固有名詞	
だすとだす	ダストダス	固有名詞	
ぞろあ	ゾロア	固有名詞	
ぞろあーく	ゾロアーク	固有名詞	
ちらーみぃ	チラーミィ	固有名詞	
ちらちーの	チラチーノ	固有名詞	
ごちむ	ゴチム	固有名詞	
ごちみる	ゴチミル	固有名詞	
ごちるぜる	ゴチルゼル	固有名詞	
ゆにらん	ユニラン	固有名詞	
だぶらん	ダブラン	固有名詞	
らんくるす	ランクルス	固有名詞	
こあるひー	コアルヒー	固有名詞	
すわんな	スワンナ	固有名詞	
ばにぷっち	バニプッチ	固有名詞	
ばにりっち	バニリッチ	固有名詞	
ばいばにら	バイバニラ	固有名詞	
しきじか	シキジカ	固有名詞	
めぶきじか	メブキジカ	固有名詞	
えもんが	エモンガ	固有名詞	
かぶるも	カブルモ	固有名詞	
しゅばるご	シュバルゴ	固有名詞	
たまげたけ	タマゲタケ	固有名詞	
もろばれる	モロバレル	固有名詞	
ぷるりる	プルリル	固有名詞	
ぶるんげる	ブルンゲル	固有名詞	
ままんぼう	ママンボウ	固有名詞	
ばちゅる	バチュル	固有名詞	
でんちゅら	デンチュラ	固有名詞	
てっしーど	テッシード	固有名詞	
なっとれい	ナットレイ	固有名詞	
ぎある	ギアル	固有名詞	
ぎぎある	ギギアル	固有名詞	
ぎぎぎある	ギギギアル	固有名詞	
しびしらす	シビシラス	固有名詞	
しびびーる	シビビール	固有名詞	
しびるどん	シビルドン	固有名詞	
りぐれー	リグレー	固有名詞	
おーべむ	オーベム	固有名詞	
ひともし	ヒトモシ	固有名詞	
らんぷらー	ランプラー	固有名詞	
しゃんでら	シャンデラ	固有名詞	
きばご	キバゴ	固有名詞	
おのんど	オノンド	固有名詞	
おののくす	オノノクス	固有名詞	
くましゅん	クマシュン	固有名詞	
つんべあー	ツンベアー	固有名詞	
ふりーじお	フリージオ	固有名詞	
ちょぼまき	チョボマキ	固有名詞	
あぎるだー	アギルダー	固有名詞	
まっぎょ	マッギョ	固有名詞	
こじょふー	コジョフー	固有名詞	
こじょんど	コジョンド	固有名詞	
くりむがん	クリムガン	固有名詞	
ごびっと	ゴビット	固有名詞	
ごるーぐ	ゴルーグ	固有名詞	
こまたな	コマタナ	固有名詞	
きりきざん	キリキザン	固有名詞	
ばっふろん	バッフロン	固有名詞	
わしぼん	ワシボン	固有名詞	
うぉーぐる	ウォーグル	固有名詞	
ばるちゃい	バルチャイ	固有名詞	
ばるじーな	バルジーナ	固有名詞	
くいたらん	クイタラン	固有名詞	
あいあんと	アイアント	固有名詞	
ものず	モノズ	固有名詞	
じへっど	ジヘッド	固有名詞	
さざんどら	サザンドラ	固有名詞	
めらるば	メラルバ	固有名詞	
うるがもす	ウルガモス	固有名詞	
こばるおん	コバルオン	固有名詞	
てらきおん	テラキオン	固有名詞	
びりじおん	ビリジオン	固有名詞	
とるねろす	トルネロス	固有名詞	
ぼるとろす	ボルトロス	固有名詞	
れしらむ	レシラム	固有名詞	
ぜくろむ	ゼクロム	固有名詞	
らんどろす	ランドロス	固有名詞	
きゅれむ	キュレム	固有名詞	
けるでぃお	ケルディオ	固有名詞	
めろえった	メロエッタ	固有名詞	
げのせくと	ゲノセクト	固有名詞	
はりまろん	ハリマロン	固有名詞	
はりぼーぐ	ハリボーグ	固有名詞	
ぶりがろん	ブリガロン	固有名詞	
ふぉっこ	フォッコ	固有名詞	
てーるなー	テールナー	固有名詞	
まふぉくしー	マフォクシー	固有名詞	
けろまつ	ケロマツ	固有名詞	
げこがしら	ゲコガシラ	固有名詞	
げっこうが	ゲッコウガ	固有名詞	
ほるびー	ホルビー	固有名詞	
ほるーど	ホルード	固有名詞	
ややこま	ヤヤコマ	固有名詞	
ひのやこま	ヒノヤコマ	固有名詞	
ふぁいあろー	ファイアロー	固有名詞	
こふきむし	コフキムシ	固有名詞	
こふーらい	コフーライ	固有名詞	
びびよん	ビビヨン	固有名詞	
ししこ	シシコ	固有名詞	
かえんじし	カエンジシ	固有名詞	
ふらべべ	フラベベ	固有名詞	
ふらえって	フラエッテ	固有名詞	
ふらーじぇす	フラージェス	固有名詞	
めぇーくる	メェークル	固有名詞	
ごーごーと	ゴーゴート	固有名詞	
やんちゃむ	ヤンチャム	固有名詞	
ごろんだ	ゴロンダ	固有名詞	
とりみあん	トリミアン	固有名詞	
にゃすぱー	ニャスパー	固有名詞	
にゃおにくす	ニャオニクス	固有名詞	
ひとつき	ヒトツキ	固有名詞	
にだんぎる	ニダンギル	固有名詞	
ぎるがるど	ギルガルド	固有名詞	
しゅしゅぷ	シュシュプ	固有名詞	
ふれふわん	フレフワン	固有名詞	
ぺろっぱふ	ペロッパフ	固有名詞	
ぺろりーむ	ペロリーム	固有名詞	
まーいーか	マーイーカ	固有名詞	
からまねろ	カラマネロ	固有名詞	
かめてて	カメテテ	固有名詞	
がめのです	ガメノデス	固有名詞	
くずもー	クズモー	固有名詞	
どらみどろ	ドラミドロ	固有名詞	
うでっぽう	ウデッポウ	固有名詞	
ぶろすたー	ブロスター	固有名詞	
えりきてる	エリキテル	固有名詞	
えれざーど	エレザード	固有名詞	
ちごらす	チゴラス	固有名詞	
がちごらす	ガチゴラス	固有名詞	
あまるす	アマルス	固有名詞	
あまるるが	アマルルガ	固有名詞	
にんふぃあ	ニンフィア	固有名詞	
るちゃぶる	ルチャブル	固有名詞	
ででんね	デデンネ	固有名詞	
めれしー	メレシー	固有名詞	
ぬめら	ヌメラ	固有名詞	
ぬめいる	ヌメイル	固有名詞	
ぬめるごん	ヌメルゴン	固有名詞	
くれっふぃ	クレッフィ	固有名詞	
ぼくれー	ボクレー	固有名詞	
おーろっと	オーロット	固有名詞	
ばけっちゃ	バケッチャ	固有名詞	
ぱんぷじん	パンプジン	固有名詞	
かちこーる	カチコール	固有名詞	
くれべーす	クレベース	固有名詞	
おんばっと	オンバット	固有名詞	
おんばーん	オンバーン	固有名詞	
ぜるねあす	ゼルネアス	固有名詞	
いべるたる	イベルタル	固有名詞	
じがるで	ジガルデ	固有名詞	
でぃあんしー	ディアンシー	固有名詞	
ふーぱ	フーパ	固有名詞	
ぼるけにおん	ボルケニオン	固有名詞	
もくろー	モクロー	固有名詞	
ふくすろー	フクスロー	固有名詞	
じゅないぱー	ジュナイパー	固有名詞	
にゃびー	ニャビー	固有名詞	
にゃひーと	ニャヒート	固有名詞	
がおがえん	ガオガエン	固有名詞	
あしまり	アシマリ	固有名詞	
おしゃまり	オシャマリ	固有名詞	
あしれーぬ	アシレーヌ	固有名詞	
つつけら	ツツケラ	固有名詞	
けららっぱ	ケララッパ	固有名詞	
どでかばし	ドデカバシ	固有名詞	
やんぐーす	ヤングース	固有名詞	
でかぐーす	デカグース	固有名詞	
あごじむし	アゴジムシ	固有名詞	
でんぢむし	デンヂムシ	固有名詞	
くわがのん	クワガノン	固有名詞	
まけんかに	マケンカニ	固有名詞	
けけんかに	ケケンカニ	固有名詞	
おどりどり	オドリドリ	固有名詞	
あぶりー	アブリー	固有名詞	
あぶりぼん	アブリボン	固有名詞	
いわんこ	イワンコ	固有名詞	
るがるがん	ルガルガン	固有名詞	
よわし	ヨワシ	固有名詞	
ひどいで	ヒドイデ	固有名詞	
どひどいで	ドヒドイデ	固有名詞	
どろばんこ	ドロバンコ	固有名詞	
ばんばどろ	バンバドロ	固有名詞	
しずくも	シズクモ	固有名詞	
おにしずくも	オニシズクモ	固有名詞	
かりきり	カリキリ	固有名詞	
ららんてす	ラランテス	固有名詞	
ねましゅ	ネマシュ	固有名詞	
ましぇーど	マシェード	固有名詞	
やとうもり	ヤトウモリ	固有名詞	
えんにゅーと	エンニュート	固有名詞	
ぬいこぐま	ヌイコグマ	固有名詞	
きてるぐま	キテルグマ	固有名詞	
あまかじ	アマカジ	固有名詞	
あままいこ	アママイコ	固有名詞	
あまーじょ	アマージョ	固有名詞	
きゅわわー	キュワワー	固有名詞	
やれゆーたん	ヤレユータン	固有名詞	
なげつけさる	ナゲツケサル	固有名詞	
こそくむし	コソクムシ	固有名詞	
ぐそくむしゃ	グソクムシャ	固有名詞	
すなばぁ	スナバァ	固有名詞	
しろですな	シロデスナ	固有名詞	
なまこぶし	ナマコブシ	固有名詞	
たいぷ:ぬる	タイプ:ヌル	固有名詞	
しるゔぁでぃ	シルヴァディ	固有名詞	
めての	メテノ	固有名詞	
ねっこあら	ネッコアラ	固有名詞	
ばくがめす	バクガメス	固有名詞	
とげでまる	トゲデマル	固有名詞	
みみっきゅ	ミミッキュ	固有名詞	
はぎぎしり	ハギギシリ	固有名詞	
じじーろん	ジジーロン	固有名詞	
だだりん	ダダリン	固有名詞	
じゃらこ	ジャラコ	固有名詞	
じゃらんご	ジャランゴ	固有名詞	
じゃららんが	ジャラランガ	固有名詞	
かぷ・こけこ	カプ・コケコ	固有名詞	
かぷ・ててふ	カプ・テテフ	固有名詞	
かぷ・ぶるる	カプ・ブルル	固有名詞	
かぷ・れひれ	カプ・レヒレ	固有名詞	
こすもっぐ	コスモッグ	固有名詞	
こすもうむ	コスモウム	固有名詞	
そるがれお	ソルガレオ	固有名詞	
るなあーら	ルナアーラ	固有名詞	
うつろいど	ウツロイド	固有名詞	
まっしぶーん	マッシブーン	固有名詞	
ふぇろーちぇ	フェローチェ	固有名詞	
でんじゅもく	デンジュモク	固有名詞	
てっかぐや	テッカグヤ	固有名詞	
かみつるぎ	カミツルギ	固有名詞	
あくじきんぐ	アクジキング	固有名詞	
ねくろずま	ネクロズマ	固有名詞	
まぎあな	マギアナ	固有名詞	
まーしゃどー	マーシャドー	固有名詞	
べべのむ	ベベノム	固有名詞	
あーごよん	アーゴヨン	固有名詞	
つんでつんで	ツンデツンデ	固有名詞	
ずがどーん	ズガドーン	固有名詞	
ぜらおら	ゼラオラ	固有名詞	
めるたん	メルタン	固有名詞	
めるめたる	メルメタル	固有名詞	
さるのり	サルノリ	固有名詞	
ばちんきー	バチンキー	固有名詞	
ごりらんだー	ゴリランダー	固有名詞	
ひばにー	ヒバニー	固有名詞	
らびふっと	ラビフット	固有名詞	
えーすばーん	エースバーン	固有名詞	
めっそん	メッソン	固有名詞	
じめれおん	ジメレオン	固有名詞	
いんてれおん	インテレオン	固有名詞	
ほしがりす	ホシガリス	固有名詞	
よくばりす	ヨクバリス	固有名詞	
ここがら	ココガラ	固有名詞	
あおがらす	アオガラス	固有名詞	
あーまーがあ	アーマーガア	固有名詞	
さっちむし	サッチムシ	固有名詞	
れどーむし	レドームシ	固有名詞	
いおるぶ	イオルブ	固有名詞	
くすね	クスネ	固有名詞	
ふぉくすらい	フォクスライ	固有名詞	
ひめんか	ヒメンカ	固有名詞	
わたしらが	ワタシラガ	固有名詞	
うーるー	ウールー	固有名詞	
ばいうーるー	バイウールー	固有名詞	
かむかめ	カムカメ	固有名詞	
かじりがめ	カジリガメ	固有名詞	
わんぱち	ワンパチ	固有名詞	
ぱるすわん	パルスワン	固有名詞	
たんどん	タンドン	固有名詞	
とろっごん	トロッゴン	固有名詞	
せきたんざん	セキタンザン	固有名詞	
かじっちゅ	カジッチュ	固有名詞	
あっぷりゅー	アップリュー	固有名詞	
たるっぷる	タルップル	固有名詞	
すなへび	スナヘビ	固有名詞	
さだいじゃ	サダイジャ	固有名詞	
うっう	ウッウ	固有名詞	
さしかます	サシカマス	固有名詞	
かますじょー	カマスジョー	固有名詞	
えれずん	エレズン	固有名詞	
すとりんだー	ストリンダー	固有名詞	
やくで	ヤクデ	固有名詞	
まるやくで	マルヤクデ	固有名詞	
たたっこ	タタッコ	固有名詞	
おとすぱす	オトスパス	固有名詞	
やばちゃ	ヤバチャ	固有名詞	
ぽっとです	ポットデス	固有名詞	
みぶりむ	ミブリム	固有名詞	
てぶりむ	テブリム	固有名詞	
ぶりむおん	ブリムオン	固有名詞	
べろばー	ベロバー	固有名詞	
ぎもー	ギモー	固有名詞	
おーろんげ	オーロンゲ	固有名詞	
たちふさぐま	タチフサグマ	固有名詞	
にゃいきんぐ	ニャイキング	固有名詞	
さにごーん	サニゴーン	固有名詞	
ねぎがないと	ネギガナイト	固有名詞	
ばりこおる	バリコオル	固有名詞	
ですばーん	デスバーン	固有名詞	
まほみる	マホミル	固有名詞	
まほいっぷ	マホイップ	固有名詞	
たいれーつ	タイレーツ	固有名詞	
ばちんうに	バチンウニ	固有名詞	
ゆきはみ	ユキハミ	固有名詞	
もすのう	モスノウ	固有名詞	
いしへんじん	イシヘンジン	固有名詞	
こおりっぽ	コオリッポ	固有名詞	
いえっさん	イエッサン	固有名詞	
もるぺこ	モルペコ	固有名詞	
ぞうどう	ゾウドウ	固有名詞	
だいおうどう	ダイオウドウ	固有名詞	
ぱっちらごん	パッチラゴン	固有名詞	
ぱっちるどん	パッチルドン	固有名詞	
うおのらごん	ウオノラゴン	固有名詞	
うおちるどん	ウオチルドン	固有名詞	
じゅらるどん	ジュラルドン	固有名詞	
どらめしや	ドラメシヤ	固有名詞	
どろんち	ドロンチ	固有名詞	
どらぱると	ドラパルト	固有名詞	
ざしあん	ザシアン	固有名詞	
ざまぜんた	ザマゼンタ	固有名詞	
むげんだいな	ムゲンダイナ	固有名詞	
だくま	ダクマ	固有名詞	
うーらおす	ウーラオス	固有名詞	
ざるーど	ザルード	固有名詞	
れじえれき	レジエレキ	固有名詞	
れじどらご	レジドラゴ	固有名詞	
ぶりざぽす	ブリザポス	固有名詞	
れいすぽす	レイスポス	固有名詞	
ばどれっくす	バドレックス	固有名詞	
あやしし	アヤシシ	固有名詞	
ばさぎり	バサギリ	固有名詞	
がちぐま	ガチグマ	固有名詞	
いだいとう	イダイトウ	固有名詞	
おおにゅーら	オオニューラ	固有名詞	
はりーまん	ハリーマン	固有名詞	
らぶとろす	ラブトロス	固有名詞	
にゃおは	ニャオハ	固有名詞	
にゃろーて	ニャローテ	固有名詞	
ますかーにゃ	マスカーニャ	固有名詞	
ほげーた	ホゲータ	固有名詞	
あちげーた	アチゲータ	固有名詞	
らうどぼーん	ラウドボーン	固有名詞	
くわっす	クワッス	固有名詞	
うぇるかも	ウェルカモ	固有名詞	
うぇーにばる	ウェーニバル	固有名詞	
ぐるとん	グルトン	固有名詞	
ぱふゅーとん	パフュートン	固有名詞	
たまんちゅら	タマンチュラ	固有名詞	
わないだー	ワナイダー	固有名詞	
まめばった	マメバッタ	固有名詞	
えくすれっぐ	エクスレッグ	固有名詞	
ぱも	パモ	固有名詞	
ぱもっと	パモット	固有名詞	
ぱーもっと	パーモット	固有名詞	
わっかねずみ	ワッカネズミ	固有名詞	
いっかねずみ	イッカネズミ	固有名詞	
ぱぴもっち	パピモッチ	固有名詞	
ばうっつぇる	バウッツェル	固有名詞	
みにーぶ	ミニーブ	固有名詞	
おりーにょ	オリーニョ	固有名詞	
おりーゔぁ	オリーヴァ	固有名詞	
いきりんこ	イキリンコ	固有名詞	
こじお	コジオ	固有名詞	
じおづむ	ジオヅム	固有名詞	
きょじおーん	キョジオーン	固有名詞	
かるぼう	カルボウ	固有名詞	
ぐれんあるま	グレンアルマ	固有名詞	
そうぶれいず	ソウブレイズ	固有名詞	
ずぴか	ズピカ	固有名詞	
はらばりー	ハラバリー	固有名詞	
かいでん	カイデン	固有名詞	
たいかいでん	タイカイデン	固有名詞	
おらちふ	オラチフ	固有名詞	
まふぃてぃふ	マフィティフ	固有名詞	
しるしゅるー	シルシュルー	固有名詞	
たぎんぐる	タギングル	固有名詞	
あのくさ	アノクサ	固有名詞	
あのほらぐさ	アノホラグサ	固有名詞	
ののくらげ	ノノクラゲ	固有名詞	
りくくらげ	リククラゲ	固有名詞	
がけがに	ガケガニ	固有名詞	
かぷさいじ	カプサイジ	固有名詞	
すこゔぃらん	スコヴィラン	固有名詞	
しがろこ	シガロコ	固有名詞	
べらかす	ベラカス	固有名詞	
ひらひな	ヒラヒナ	固有名詞	
くえすぱとら	クエスパトラ	固有名詞	
かぬちゃん	カヌチャン	固有名詞	
なかぬちゃん	ナカヌチャン	固有名詞	
でかぬちゃん	デカヌチャン	固有名詞	
うみでぃぐだ	ウミディグダ	固有名詞	
うみとりお	ウミトリオ	固有名詞	
おとしどり	オトシドリ	固有名詞	
なみいるか	ナミイルカ	固有名詞	
いるかまん	イルカマン	固有名詞	
ぶろろん	ブロロン	固有名詞	
ぶろろろーむ	ブロロローム	固有名詞	
もととかげ	モトトカゲ	固有名詞	
みみずず	ミミズズ	固有名詞	
きらーめ	キラーメ	固有名詞	
きらふろる	キラフロル	固有名詞	
ぼち	ボチ	固有名詞	
はかどっぐ	ハカドッグ	固有名詞	
からみんご	カラミンゴ	固有名詞	
あるくじら	アルクジラ	固有名詞	
はるくじら	ハルクジラ	固有名詞	
みがるーさ	ミガルーサ	固有名詞	
へいらっしゃ	ヘイラッシャ	固有名詞	
しゃりたつ	シャリタツ	固有名詞	
このよざる	コノヨザル	固有名詞	
どおー	ドオー	固有名詞	
りききりん	リキキリン	固有名詞	
のここっち	ノココッチ	固有名詞	
どどげざん	ドドゲザン	固有名詞	
いだいなきば	イダイナキバ	固有名詞	
さけぶしっぽ	サケブシッポ	固有名詞	
あらぶるたけ	アラブルタケ	固有名詞	
はばたくかみ	ハバタクカミ	固有名詞	
ちをはうはね	チヲハウハネ	固有名詞	
すなのけがわ	スナノケガワ	固有名詞	
てつのわだち	テツノワダチ	固有名詞	
てつのつつみ	テツノツツミ	固有名詞	
てつのかいな	テツノカイナ	固有名詞	
てつのこうべ	テツノコウベ	固有名詞	
てつのどくが	テツノドクガ	固有名詞	
てつのいばら	テツノイバラ	固有名詞	
せびえ	セビエ	固有名詞	
せごーる	セゴール	固有名詞	
せぐれいぶ	セグレイブ	固有名詞	
これくれー	コレクレー	固有名詞	
さーふごー	サーフゴー	固有名詞	
ちおんじぇん	チオンジェン	固有名詞	
ぱおじあん	パオジアン	固有名詞	
でぃんるー	ディンルー	固有名詞	
いーゆい	イーユイ	固有名詞	
とどろくつき	トドロクツキ	固有名詞	
てつのぶじん	テツノブジン	固有名詞	
こらいどん	コライドン	固有名詞	
みらいどん	ミライドン	固有名詞	
うねるみなも	ウネルミナモ	固有名詞	
てつのいさは	テツノイサハ	固有名詞	
かみっちゅ	カミッチュ	固有名詞	
ちゃです	チャデス	固有名詞	
やばそちゃ	ヤバソチャ	固有名詞	
いいねいぬ	イイネイヌ	固有名詞	
ましましら	マシマシラ	固有名詞	
きちきぎす	キチキギス	固有名詞	
おーがぽん	オーガポン	固有名詞	
ぶりじゅらす	ブリジュラス	固有名詞	
かみつおろち	カミツオロチ	固有名詞	
うがつほむら	ウガツホムラ	固有名詞	
たけるらいこ	タケルライコ	固有名詞	
てつのいわお	テツノイワオ	固有名詞	
てつのかしら	テツノカシラ	固有名詞	
てらぱごす	テラパゴス	固有名詞	
ももわろう	モモワロウ	固有名詞	
